AAAAACATCAA -> AAAACATCAAT
AAAAACCCCAT -> AAAACCCCATA
AAAAACGCATA -> AAAACGCATAC
AAAAAGTAAGC -> AAAAGTAAGCT
AAAAAGTGTAA -> AAAAGTGTAAT
AAAAATGATCG -> AAAATGATCGG
AAAACATCAAT -> AAACATCAATG
AAAACCATCCC -> AAACCATCCCC
AAAACCCCATA -> AAACCCCATAG
AAAACGCATAC -> AAACGCATACA
AAAAGCCAACT -> AAAGCCAACTG
AAAAGTAAGCT -> AAAGTAAGCTT
AAAAGTGATCA -> AAAGTGATCAA
AAAAGTGCCGA -> AAAGTGCCGAA
AAAAGTGTAAT -> AAAGTGTAATC
AAAATAAGCTG -> AAATAAGCTGA
AAAATGATCGG -> AAATGATCGGT
AAAATTTGTGC -> AAATTTGTGCA
AAACACCGGAA -> AACACCGGAAG
AAACATCAATG -> AACATCAATGT
AAACCATCCCC -> AACCATCCCCC
AAACCCCATAG -> AACCCCATAGG
AAACGCATACA -> AACGCATACAA
AAACGGATAGT -> AACGGATAGTT
AAACGGCAGGC -> AACGGCAGGCC
AAACGTGATTA -> AACGTGATTAG
AAACGTTTGAT -> AACGTTTGATT
AAAGCATATCG -> AAGCATATCGC
AAAGCCAACTG -> AAGCCAACTGC
AAAGCGGGCTG -> AAGCGGGCTGC
AAAGTAAGCTT -> AAGTAAGCTTA
AAAGTGATCAA -> AAGTGATCAAG
AAAGTGCCGAA -> AAGTGCCGAAC
AAAGTGTAATC -> AAGTGTAATCG
AAAGTTGAGGA -> AAGTTGAGGAC
AAATAAGCTGA -> AATAAGCTGAA
AAATACGAGCA -> AATACGAGCAA
AAATGATCGGT -> AATGATCGGTG
AAATGCCCCGC -> AATGCCCCGCT
AAATGTACCCG -> AATGTACCCGA
AAATTGTCCGT -> AATTGTCCGTT
AAATTTGTGCA -> AATTTGTGCAA
AACAAAAAGTA -> ACAAAAAGTAA
AACACCGGAAG -> ACACCGGAAGC
AACACCTTCCC -> ACACCTTCCCG
AACACTAGCAA -> ACACTAGCAAG
AACAGCTCGAT -> ACAGCTCGATT
AACATCAATGT -> ACATCAATGTC
AACATTTGAGT -> ACATTTGAGTT
AACCATCCCCC -> ACCATCCCCCG
AACCATCTTGG -> ACCATCTTGGT
AACCCATTGAC -> ACCCATTGACG
AACCCCATAGG -> ACCCCATAGGT
AACCCGCCTAG -> ACCCGCCTAGG
AACCGCCTGGC -> ACCGCCTGGCC
AACCGGAGTTA -> ACCGGAGTTAA
AACCTCAGCAT -> ACCTCAGCATA
AACCTTCGAGG -> ACCTTCGAGGT
AACGATCCCTC -> ACGATCCCTCA
AACGATGGTTC -> ACGATGGTTCC
AACGCATACAA -> ACGCATACAAA
AACGGATAGTT -> ACGGATAGTTT
AACGGCAGGCC -> ACGGCAGGCCC
AACGTGATTAG -> ACGTGATTAGA
AACGTTTGATT -> ACGTTTGATTT
AACTACCTGGC -> ACTACCTGGCA
AACTATCAGTT -> ACTATCAGTTC
AACTGCAGACG -> ACTGCAGACGT
AACTTATCCCG -> ACTTATCCCGG
AACTTGTATTA -> ACTTGTATTAC
AAGAACACCTT -> AGAACACCTTC
AAGAATGAAAC -> AGAATGAAACG
AAGACTCAGAA -> AGACTCAGAAG
AAGAGGTCCAC -> AGAGGTCCACC
AAGATAGAAAC -> AGATAGAAACG
AAGCATATCGC -> AGCATATCGCG
AAGCCAACTGC -> AGCCAACTGCA
AAGCCATTATG -> AGCCATTATGA
AAGCCCATTTC -> AGCCCATTTCT
AAGCGCACCGG -> AGCGCACCGGG
AAGCGCACGGT -> AGCGCACGGTG
AAGCGCTCCGA -> AGCGCTCCGAC
AAGCGGGCTGC -> AGCGGGCTGCC
AAGCTAGTTCC -> AGCTAGTTCCA
AAGCTCATTCC -> AGCTCATTCCG
AAGCTGAACAG -> AGCTGAACAGC
AAGCTGTGTAC -> AGCTGTGTACC
AAGCTTAAGGG -> AGCTTAAGGGG
AAGGACCATAC -> AGGACCATACT
AAGGGATTCTT -> AGGGATTCTTG
AAGGGGCATGC -> AGGGGCATGCT
AAGGTCACGAT -> AGGTCACGATT
AAGTAAGCTTA -> AGTAAGCTTAA
AAGTAGAGGTG -> AGTAGAGGTGG
AAGTGATCAAG -> AGTGATCAAGC
AAGTGCCGAAC -> AGTGCCGAACC
AAGTGTAATCG -> AGTGTAATCGT
AAGTTCTCCAT -> AGTTCTCCATA
AAGTTGAGGAC -> AGTTGAGGACC
AAGTTTCGGAG -> AGTTTCGGAGG
AATAAGCTGAA -> ATAAGCTGAAC
AATACATCGGT -> ATACATCGGTA
AATACCCGCCT -> ATACCCGCCTT
AATACGAGCAA -> ATACGAGCAAA
AATAGACTACC -> ATAGACTACCC
AATCAACTATC -> ATCAACTATCA
AATCAGGACAC -> ATCAGGACACT
AATCCAGTCAA -> ATCCAGTCAAG
AATCGCACGCA -> ATCGCACGCAG
AATCGCGCGAG -> ATCGCGCGAGG
AATCGGAGGAC -> ATCGGAGGACA
AATCGTCCTCC -> ATCGTCCTCCC
AATCGTTGAGG -> ATCGTTGAGGT
AATGAAACGTG -> ATGAAACGTGA
AATGACTATGT -> ATGACTATGTG
AATGATCGGTG -> ATGATCGGTGT
AATGCCCCGCT -> ATGCCCCGCTA
AATGTACCCGA -> ATGTACCCGAT
AATGTCCTGGT -> ATGTCCTGGTG
AATTATATTGC -> ATTATATTGCA
AATTATGCTGC -> ATTATGCTGCA
AATTATGTTTG -> ATTATGTTTGA
AATTGAGCCTG -> ATTGAGCCTGA
AATTGTCCGTT -> ATTGTCCGTTT
AATTTCCTCGG -> ATTTCCTCGGA
AATTTGTGCAA -> ATTTGTGCAAC
AATTTTATCCT -> ATTTTATCCTG
AATTTTCTTCA -> ATTTTCTTCAT
ACAAAAACGCA -> CAAAAACGCAT
ACAAAAAGTAA -> CAAAAAGTAAG
ACAAAAATGAT -> CAAAAATGATC
ACAAACACCGG -> CAAACACCGGA
ACAACATTTGA -> CAACATTTGAG
ACAACCCATTG -> CAACCCATTGA
ACAAGCTAGTT -> CAAGCTAGTTC
ACACCACTCAT -> CACCACTCATC
ACACCGGAAGC -> CACCGGAAGCG
ACACCTTCCCG -> CACCTTCCCGA
ACACGCTTTGT -> CACGCTTTGTT
ACACTAGCAAG -> CACTAGCAAGG
ACACTGTTCCG -> CACTGTTCCGG
ACAGAAGATAG -> CAGAAGATAGA
ACAGCACTTTT -> CAGCACTTTTT
ACAGCCCTAGA -> CAGCCCTAGAG
ACAGCTCGATT -> CAGCTCGATTA
ACATCAATGTC -> CATCAATGTCC
ACATCGGTACT -> CATCGGTACTT
ACATGAGCGCG -> CATGAGCGCGA
ACATGTCTCCG -> CATGTCTCCGT
ACATTACGTCG -> CATTACGTCGG
ACATTAGGCAG -> CATTAGGCAGT
ACATTCGAATA -> CATTCGAATAC
ACATTTGAGTT -> CATTTGAGTTC
ACCAATCGCAC -> CCAATCGCACG
ACCACATTAGG -> CCACATTAGGC
ACCACTCATCC -> CCACTCATCCT
ACCACTCATTA -> CCACTCATTAT
ACCAGAGTTGC -> CCAGAGTTGCC
ACCAGTGCACG -> CCAGTGCACGA
ACCATACTACC -> CCATACTACCT
ACCATCCCCCG -> CCATCCCCCGT
ACCATCTTGGT -> CCATCTTGGTT
ACCATGTAGGA -> CCATGTAGGAG
ACCCATGGATA -> CCCATGGATAC
ACCCATTGACG -> CCCATTGACGC
ACCCCATAGGT -> CCCCATAGGTT
ACCCCCAAAAG -> CCCCCAAAAGC
ACCCCGTACTG -> CCCCGTACTGG
ACCCGATTCTG -> CCCGATTCTGG
ACCCGCCTAGG -> CCCGCCTAGGC
ACCCGCCTTGT -> CCCGCCTTGTA
ACCCGCTCTAG -> CCCGCTCTAGA
ACCCGGGTGCA -> CCCGGGTGCAC
ACCCGTCTCTG -> CCCGTCTCTGA
ACCCTGGTAAT -> CCCTGGTAATC
ACCGAGCGCCG -> CCGAGCGCCGT
ACCGATAAGAA -> CCGATAAGAAC
ACCGCCTGGCC -> CCGCCTGGCCT
ACCGCTCTATA -> CCGCTCTATAC
ACCGCTGGAAG -> CCGCTGGAAGC
ACCGGAAGCGC -> CCGGAAGCGCA
ACCGGAGTTAA -> CCGGAGTTAAC
ACCGGGATCAT -> CCGGGATCATA
ACCGTCACGGT -> CCGTCACGGTA
ACCTCAGCATA -> CCTCAGCATAA
ACCTCGAAATG -> CCTCGAAATGT
ACCTGGCACCC -> CCTGGCACCCG
ACCTTCCCGAA -> CCTTCCCGAAT
ACCTTCCGGTT -> CCTTCCGGTTG
ACCTTCGAGGT -> CCTTCGAGGTC
ACCTTGGGTTA -> CCTTGGGTTAT
ACGACACGCTT -> CGACACGCTTT
ACGACGAGATT -> CGACGAGATTT
ACGACTCTCAC -> CGACTCTCACA
ACGACTGAACG -> CGACTGAACGA
ACGAGATTTAT -> CGAGATTTATG
ACGAGCAAATT -> CGAGCAAATTG
ACGAGGCGTGA -> CGAGGCGTGAA
ACGATAGACAG -> CGATAGACAGA
ACGATCCCTCA -> CGATCCCTCAG
ACGATGGTTCC -> CGATGGTTCCA
ACGATTGACAA -> CGATTGACAAA
ACGCAAGTTCT -> CGCAAGTTCTC
ACGCAAGTTTC -> CGCAAGTTTCG
ACGCAGAGGTC -> CGCAGAGGTCA
ACGCATACAAA -> CGCATACAAAC
ACGCTTTGTTC -> CGCTTTGTTCG
ACGGATAGTTT -> CGGATAGTTTG
ACGGCAGGCCC -> CGGCAGGCCCG
ACGGTATATTC -> CGGTATATTCA
ACGGTGACCCG -> CGGTGACCCGG
ACGTCGCATCT -> CGTCGCATCTG
ACGTCGCGTGG -> CGTCGCGTGGA
ACGTCGGCCAT -> CGTCGGCCATA
ACGTGATTAGA -> CGTGATTAGAT
ACGTTCGTGAC -> CGTTCGTGACG
ACGTTTACGAG -> CGTTTACGAGG
ACGTTTGATTT -> CGTTTGATTTG
ACGTTTGCTTG -> CGTTTGCTTGT
ACTACCCGTCT -> CTACCCGTCTC
ACTACCTGGCA -> CTACCTGGCAC
ACTACCTTCCG -> CTACCTTCCGG
ACTACGTTCGT -> CTACGTTCGTG
ACTAGCAAGGG -> CTAGCAAGGGA
ACTATCAGTTC -> CTATCAGTTCG
ACTATGCAACC -> CTATGCAACCC
ACTATGTGCCG -> CTATGTGCCGA
ACTCAGAAGTA -> CTCAGAAGTAG
ACTCATCCTGG -> CTCATCCTGGC
ACTCATTATTT -> CTCATTATTTA
ACTCCGTGGCC -> CTCCGTGGCCA
ACTCGTGCTTG -> CTCGTGCTTGC
ACTCTCACAGC -> CTCTCACAGCA
ACTGAACGATC -> CTGAACGATCC
ACTGCAGACGT -> CTGCAGACGTT
ACTGCCTAAGG -> CTGCCTAAGGA
ACTGGTCCTGG -> CTGGTCCTGGC
ACTGGTGTAAA -> CTGGTGTAAAC
ACTGTATCAGT -> CTGTATCAGTG
ACTGTTCCGGG -> CTGTTCCGGGT
ACTTATCCCGG -> CTTATCCCGGA
ACTTCGCCCAC -> CTTCGCCCACC
ACTTCGTGGCC -> CTTCGTGGCCG
ACTTCTACAAA -> CTTCTACAAAA
ACTTGTATTAC -> CTTGTATTACG
ACTTTTTTGGG -> CTTTTTTGGGA
AGAAACGGCAG -> GAAACGGCAGG
AGAAATGCCCC -> GAAATGCCCCG
AGAACACCTTC -> GAACACCTTCC
AGAACCATCTT -> GAACCATCTTG
AGAACCGCCTG -> GAACCGCCTGG
AGAACTTGTAT -> GAACTTGTATT
AGAAGATAGAA -> GAAGATAGAAA
AGAAGCCCATT -> GAAGCCCATTT
AGAAGTAGAGG -> GAAGTAGAGGT
AGAATGAAACG -> GAATGAAACGT
AGACAGAAGAT -> GACAGAAGATA
AGACCAGTGCA -> GACCAGTGCAC
AGACCGCTCTA -> GACCGCTCTAT
AGACGTTTACG -> GACGTTTACGA
AGACTACCCGT -> GACTACCCGTC
AGACTCAGAAG -> GACTCAGAAGT
AGACTGTATCA -> GACTGTATCAG
AGAGCAATGAC -> GAGCAATGACT
AGAGCTACCTC -> GAGCTACCTCG
AGAGCTCCTCG -> GAGCTCCTCGT
AGAGCTGGCAA -> GAGCTGGCAAA
AGAGGTCAGCA -> GAGGTCAGCAT
AGAGGTCCACC -> GAGGTCCACCC
AGAGGTGGGTC -> GAGGTGGGTCC
AGAGTTGCCTG -> GAGTTGCCTGA
AGAGTTTCACC -> GAGTTTCACCG
AGATAGAAACG -> GATAGAAACGG
AGATCCCAGTG -> GATCCCAGTGA
AGATCGTGGTT -> GATCGTGGTTA
AGATTGCGAGC -> GATTGCGAGCA
AGATTGGGGGG -> GATTGGGGGGG
AGATTTATGCT -> GATTTATGCTT
AGCAAATTGTC -> GCAAATTGTCC
AGCAACAAAAA -> GCAACAAAAAG
AGCAAGGGATT -> GCAAGGGATTC
AGCAATCGCGC -> GCAATCGCGCG
AGCAATGACTA -> GCAATGACTAT
AGCACTTTTTT -> GCACTTTTTTG
AGCATAATCCA -> GCATAATCCAG
AGCATATCGCG -> GCATATCGCGT
AGCATGGTCCT -> GCATGGTCCTG
AGCCAACTGCA -> GCCAACTGCAG
AGCCATTATGA -> GCCATTATGAG
AGCCCATTTCT -> GCCCATTTCTT
AGCCCTAGAGC -> GCCCTAGAGCT
AGCCTGACATG -> GCCTGACATGT
AGCGCACCGGG -> GCGCACCGGGA
AGCGCACGGTG -> GCGCACGGTGA
AGCGCCGTGTC -> GCGCCGTGTCC
AGCGCGATTGG -> GCGCGATTGGC
AGCGCTCCGAC -> GCGCTCCGACC
AGCGGGCTGCC -> GCGGGCTGCCT
AGCGGTCATTT -> GCGGTCATTTT
AGCGTTCGAGG -> GCGTTCGAGGA
AGCTACCTCGA -> GCTACCTCGAA
AGCTAGTTCCA -> GCTAGTTCCAC
AGCTCATTCCG -> GCTCATTCCGA
AGCTCCTCGTT -> GCTCCTCGTTC
AGCTCGATTAC -> GCTCGATTACC
AGCTGAACAGC -> GCTGAACAGCT
AGCTGCCTAAA -> GCTGCCTAAAG
AGCTGGCAAAA -> GCTGGCAAAAG
AGCTGTGTACC -> GCTGTGTACCA
AGCTTAAGGGG -> GCTTAAGGGGC
AGGAAGCCATT -> GGAAGCCATTA
AGGAAGCGCTC -> GGAAGCGCTCC
AGGACAACATT -> GGACAACATTT
AGGACACTGTT -> GGACACTGTTC
AGGACCATACT -> GGACCATACTA
AGGACCCCCAA -> GGACCCCCAAA
AGGAGAAATGC -> GGAGAAATGCC
AGGCAATTTTC -> GGCAATTTTCT
AGGCACATTAC -> GGCACATTACG
AGGCAGTGTGG -> GGCAGTGTGGC
AGGCCCGGTTA -> GGCCCGGTTAG
AGGCGAGAACC -> GGCGAGAACCA
AGGCGCAAAAG -> GGCGCAAAAGT
AGGCGGCATGC -> GGCGGCATGCC
AGGCGTGAAAA -> GGCGTGAAAAA
AGGGAATAGAC -> GGGAATAGACT
AGGGACTGGTC -> GGGACTGGTCC
AGGGAGAACCG -> GGGAGAACCGC
AGGGAGGGAAT -> GGGAGGGAATA
AGGGATTCTTG -> GGGATTCTTGT
AGGGCAGACCG -> GGGCAGACCGC
AGGGGCATGCT -> GGGGCATGCTA
AGGTCACGATT -> GGTCACGATTG
AGGTCACTGCC -> GGTCACTGCCT
AGGTCAGCATG -> GGTCAGCATGG
AGGTCCACCCT -> GGTCCACCCTG
AGGTCGATATG -> GGTCGATATGA
AGGTGCTGGGA -> GGTGCTGGGAC
AGGTGGGGTCG -> GGTGGGGTCGG
AGGTGGGTCCT -> GGTGGGTCCTG
AGGTTTGGAGA -> GGTTTGGAGAG
AGTAACGATGG -> GTAACGATGGT
AGTAAGCTTAA -> GTAAGCTTAAG
AGTACTATGCA -> GTACTATGCAA
AGTAGAGGTGG -> GTAGAGGTGGG
AGTCAAGAATG -> GTCAAGAATGA
AGTCGAACTTA -> GTCGAACTTAT
AGTGACGCAAG -> GTGACGCAAGT
AGTGAGTGTGT -> GTGAGTGTGTC
AGTGATCAAGC -> GTGATCAAGCT
AGTGATGTCAG -> GTGATGTCAGA
AGTGCACGACG -> GTGCACGACGA
AGTGCCGAACC -> GTGCCGAACCT
AGTGGGCTAAA -> GTGGGCTAAAG
AGTGGGTGTGC -> GTGGGTGTGCT
AGTGTAATCGT -> GTGTAATCGTC
AGTGTGGCTAT -> GTGTGGCTATC
AGTGTGTCTAC -> GTGTGTCTACC
AGTTAACCTCA -> GTTAACCTCAG
AGTTATTTGGC -> GTTATTTGGCC
AGTTCCAAAAA -> GTTCCAAAAAC
AGTTCCACAAC -> GTTCCACAACC
AGTTCGAGCTG -> GTTCGAGCTGC
AGTTCTCCATA -> GTTCTCCATAC
AGTTGAGGACC -> GTTGAGGACCC
AGTTGCCTGAC -> GTTGCCTGACG
AGTTTCACCGC -> GTTTCACCGCT
AGTTTCGGAGG -> GTTTCGGAGGT
AGTTTGGTGTG -> GTTTGGTGTGG
ATAAGAACACC -> TAAGAACACCT
ATAAGCTGAAC -> TAAGCTGAACA
ATAATCCAGTC -> TAATCCAGTCA
ATAATTATGCT -> TAATTATGCTG
ATACAAACACC -> TACAAACACCG
ATACAGCCCTA -> TACAGCCCTAG
ATACATCGGTA -> TACATCGGTAC
ATACCACTCAT -> TACCACTCATT
ATACCCGCCTT -> TACCCGCCTTG
ATACGAGCAAA -> TACGAGCAAAT
ATACGTTTGCT -> TACGTTTGCTT
ATACTACCTTC -> TACTACCTTCC
ATACTCGTGCT -> TACTCGTGCTT
ATAGAAACGGC -> TAGAAACGGCA
ATAGACAGAAG -> TAGACAGAAGA
ATAGACTACCC -> TAGACTACCCG
ATAGAGCTGGC -> TAGAGCTGGCA
ATAGGTTTGGA -> TAGGTTTGGAG
ATAGTTTGGTG -> TAGTTTGGTGT
ATATATCCTAG -> TATATCCTAGT
ATATCCTAGTG -> TATCCTAGTGA
ATATCGCGTGG -> TATCGCGTGGT
ATATGAATCAG -> TATGAATCAGG
ATATTCACGAC -> TATTCACGACA
ATATTCATACG -> TATTCATACGT
ATATTGCATGC -> TATTGCATGCC
ATCAACTATCA -> TCAACTATCAG
ATCAAGCTCAT -> TCAAGCTCATT
ATCAATGTCCT -> TCAATGTCCTG
ATCAGGACACT -> TCAGGACACTG
ATCAGGGAGAA -> TCAGGGAGAAC
ATCAGTGACGC -> TCAGTGACGCA
ATCAGTTCGAG -> TCAGTTCGAGC
ATCATAATTAT -> TCATAATTATG
ATCCAGTCAAG -> TCCAGTCAAGA
ATCCCAGTGAT -> TCCCAGTGATG
ATCCCCCGTCA -> TCCCCCGTCAG
ATCCCGGAAGA -> TCCCGGAAGAC
ATCCCTCAGTG -> TCCCTCAGTGG
ATCCCTCGGAT -> TCCCTCGGATA
ATCCTAATTAT -> TCCTAATTATG
ATCCTAGTGAG -> TCCTAGTGAGT
ATCCTAGTTAT -> TCCTAGTTATT
ATCCTGCTAAT -> TCCTGCTAATC
ATCCTGGCAAT -> TCCTGGCAATT
ATCGCACCGAG -> TCGCACCGAGC
ATCGCACGCAG -> TCGCACGCAGA
ATCGCCCCTTT -> TCGCCCCTTTT
ATCGCGCGAGG -> TCGCGCGAGGT
ATCGCGTGGTT -> TCGCGTGGTTG
ATCGGAGGACA -> TCGGAGGACAA
ATCGGTACTTC -> TCGGTACTTCT
ATCGGTGTTAT -> TCGGTGTTATC
ATCGTCCTCCC -> TCGTCCTCCCC
ATCGTGGTTAA -> TCGTGGTTAAA
ATCGTTGAGGT -> TCGTTGAGGTC
ATCTGACATGA -> TCTGACATGAG
ATCTTGGTTTA -> TCTTGGTTTAA
ATGAAACGTGA -> TGAAACGTGAT
ATGAATCAGGA -> TGAATCAGGAC
ATGACTATGTG -> TGACTATGTGC
ATGAGAAGCCC -> TGAGAAGCCCA
ATGAGCGCGAT -> TGAGCGCGATT
ATGAGGGCAGA -> TGAGGGCAGAC
ATGATCGGTGT -> TGATCGGTGTT
ATGCAACCCGC -> TGCAACCCGCC
ATGCAGAGTTT -> TGCAGAGTTTC
ATGCCCCGCTA -> TGCCCCGCTAT
ATGCCGAATCG -> TGCCGAATCGG
ATGCCTCAACT -> TGCCTCAACTA
ATGCTAGGGAC -> TGCTAGGGACT
ATGCTGCAAGC -> TGCTGCAAGCT
ATGCTTACAAG -> TGCTTACAAGC
ATGGATACTCG -> TGGATACTCGT
ATGGGCCTCGG -> TGGGCCTCGGT
ATGGTCCTGCA -> TGGTCCTGCAG
ATGGTTCCAAG -> TGGTTCCAAGA
ATGTACCCGAT -> TGTACCCGATT
ATGTAGGAGAA -> TGTAGGAGAAA
ATGTCAGAACT -> TGTCAGAACTT
ATGTCCTGGTG -> TGTCCTGGTGG
ATGTCTCCGTG -> TGTCTCCGTGA
ATGTGCCGACT -> TGTGCCGACTA
ATGTTCCCACC -> TGTTCCCACCA
ATGTTTGAGTC -> TGTTTGAGTCG
ATTACCGTCAC -> TTACCGTCACG
ATTACGACTCT -> TTACGACTCTC
ATTACGTCGGC -> TTACGTCGGCC
ATTAGATCCCA -> TTAGATCCCAG
ATTAGGAAGCC -> TTAGGAAGCCA
ATTAGGCAGTG -> TTAGGCAGTGT
ATTATATTGCA -> TTATATTGCAT
ATTATGAGAAG -> TTATGAGAAGC
ATTATGAGGGC -> TTATGAGGGCA
ATTATGCTGCA -> TTATGCTGCAA
ATTATGTTTGA -> TTATGTTTGAG
ATTATTATGAG -> TTATTATGAGG
ATTATTTACTC -> TTATTTACTCC
ATTCACGACAC -> TTCACGACACG
ATTCATACGTT -> TTCATACGTTT
ATTCCGAGCGG -> TTCCGAGCGGT
ATTCGAATACC -> TTCGAATACCC
ATTCTGGTCGG -> TTCTGGTCGGC
ATTCTTGTATG -> TTCTTGTATGT
ATTGACAAAAA -> TTGACAAAAAC
ATTGACGCAAG -> TTGACGCAAGT
ATTGAGCCTGA -> TTGAGCCTGAC
ATTGCATGCCG -> TTGCATGCCGA
ATTGCGAGCAA -> TTGCGAGCAAC
ATTGGCTGTGT -> TTGGCTGTGTA
ATTGGGGGGGG -> TTGGGGGGGGA
ATTGTCCGTTT -> TTGTCCGTTTT
ATTTACTCCGT -> TTTACTCCGTG
ATTTATGCTTA -> TTTATGCTTAC
ATTTCCTCGGA -> TTTCCTCGGAT
ATTTCTTGAGA -> TTTCTTGAGAT
ATTTGAATTTC -> TTTGAATTTCC
ATTTGAGTTCC -> TTTGAGTTCCA
ATTTGGCCGCT -> TTTGGCCGCTA
ATTTGTACGTC -> TTTGTACGTCG
ATTTGTGCAAC -> TTTGTGCAACA
ATTTTATCCTG -> TTTTATCCTGC
ATTTTCTTCAT -> TTTTCTTCATT
ATTTTGTAAGG -> TTTTGTAAGGT
CAAAAACATCA -> AAAAACATCAA
CAAAAACGCAT -> AAAAACGCATA
CAAAAAGTAAG -> AAAAAGTAAGC
CAAAAATGATC -> AAAAATGATCG
CAAAAGCCAAC -> AAAAGCCAACT
CAAAAGTGATC -> AAAAGTGATCA
CAAAAGTGCCG -> AAAAGTGCCGA
CAAACACCGGA -> AAACACCGGAA
CAAATTGTCCG -> AAATTGTCCGT
CAACAAAAAGT -> AACAAAAAGTA
CAACACTAGCA -> AACACTAGCAA
CAACATTTGAG -> AACATTTGAGT
CAACCCATTGA -> AACCCATTGAC
CAACCCGCCTA -> AACCCGCCTAG
CAACTACCTGG -> AACTACCTGGC
CAACTATCAGT -> AACTATCAGTT
CAACTGCAGAC -> AACTGCAGACG
CAAGAATGAAA -> AAGAATGAAAC
CAAGAGGTCCA -> AAGAGGTCCAC
CAAGCTAGTTC -> AAGCTAGTTCC
CAAGCTCATTC -> AAGCTCATTCC
CAAGCTGTGTA -> AAGCTGTGTAC
CAAGGGATTCT -> AAGGGATTCTT
CAAGTTCTCCA -> AAGTTCTCCAT
CAAGTTTCGGA -> AAGTTTCGGAG
CAATCGCACGC -> AATCGCACGCA
CAATCGCGCGA -> AATCGCGCGAG
CAATGACTATG -> AATGACTATGT
CAATGTCCTGG -> AATGTCCTGGT
CAATTATATTG -> AATTATATTGC
CAATTTTCTTC -> AATTTTCTTCA
CACAACCCATT -> ACAACCCATTG
CACACCACTCA -> ACACCACTCAT
CACAGCACTTT -> ACAGCACTTTT
CACATTACGTC -> ACATTACGTCG
CACATTAGGCA -> ACATTAGGCAG
CACCACATTAG -> ACCACATTAGG
CACCACTCATC -> ACCACTCATCC
CACCCGCTCTA -> ACCCGCTCTAG
CACCCTGGTAA -> ACCCTGGTAAT
CACCGAGCGCC -> ACCGAGCGCCG
CACCGATAAGA -> ACCGATAAGAA
CACCGCTGGAA -> ACCGCTGGAAG
CACCGGAAGCG -> ACCGGAAGCGC
CACCGGGATCA -> ACCGGGATCAT
CACCTTCCCGA -> ACCTTCCCGAA
CACCTTGGGTT -> ACCTTGGGTTA
CACGACACGCT -> ACGACACGCTT
CACGACGAGAT -> ACGACGAGATT
CACGATAGACA -> ACGATAGACAG
CACGATTGACA -> ACGATTGACAA
CACGCAGAGGT -> ACGCAGAGGTC
CACGCTTTGTT -> ACGCTTTGTTC
CACGGTATATT -> ACGGTATATTC
CACGGTGACCC -> ACGGTGACCCG
CACTAGCAAGG -> ACTAGCAAGGG
CACTCATCCTG -> ACTCATCCTGG
CACTCATTATT -> ACTCATTATTT
CACTGCCTAAG -> ACTGCCTAAGG
CACTGTTCCGG -> ACTGTTCCGGG
CACTTTTTTGG -> ACTTTTTTGGG
CAGAACTTGTA -> AGAACTTGTAT
CAGAAGATAGA -> AGAAGATAGAA
CAGAAGTAGAG -> AGAAGTAGAGG
CAGACCGCTCT -> AGACCGCTCTA
CAGACGTTTAC -> AGACGTTTACG
CAGACTGTATC -> AGACTGTATCA
CAGAGGTCAGC -> AGAGGTCAGCA
CAGAGTTGCCT -> AGAGTTGCCTG
CAGAGTTTCAC -> AGAGTTTCACC
CAGCACTTTTT -> AGCACTTTTTT
CAGCATAATCC -> AGCATAATCCA
CAGCATGGTCC -> AGCATGGTCCT
CAGCCCTAGAG -> AGCCCTAGAGC
CAGCTCGATTA -> AGCTCGATTAC
CAGGACACTGT -> AGGACACTGTT
CAGGCCCGGTT -> AGGCCCGGTTA
CAGGCGCAAAA -> AGGCGCAAAAG
CAGGGAGAACC -> AGGGAGAACCG
CAGTAACGATG -> AGTAACGATGG
CAGTCAAGAAT -> AGTCAAGAATG
CAGTGACGCAA -> AGTGACGCAAG
CAGTGATGTCA -> AGTGATGTCAG
CAGTGCACGAC -> AGTGCACGACG
CAGTGGGCTAA -> AGTGGGCTAAA
CAGTGTGGCTA -> AGTGTGGCTAT
CAGTTCGAGCT -> AGTTCGAGCTG
CATAATCCAGT -> ATAATCCAGTC
CATAATTATGC -> ATAATTATGCT
CATACAAACAC -> ATACAAACACC
CATACAGCCCT -> ATACAGCCCTA
CATACGTTTGC -> ATACGTTTGCT
CATACTACCTT -> ATACTACCTTC
CATAGGTTTGG -> ATAGGTTTGGA
CATATATCCTA -> ATATATCCTAG
CATATCGCGTG -> ATATCGCGTGG
CATATTCATAC -> ATATTCATACG
CATCAATGTCC -> ATCAATGTCCT
CATCCCCCGTC -> ATCCCCCGTCA
CATCCTAATTA -> ATCCTAATTAT
CATCCTGGCAA -> ATCCTGGCAAT
CATCGGTACTT -> ATCGGTACTTC
CATCTGACATG -> ATCTGACATGA
CATCTTGGTTT -> ATCTTGGTTTA
CATGAGCGCGA -> ATGAGCGCGAT
CATGCAGAGTT -> ATGCAGAGTTT
CATGCCGAATC -> ATGCCGAATCG
CATGCCTCAAC -> ATGCCTCAACT
CATGCTAGGGA -> ATGCTAGGGAC
CATGGATACTC -> ATGGATACTCG
CATGGTCCTGC -> ATGGTCCTGCA
CATGTAGGAGA -> ATGTAGGAGAA
CATGTCTCCGT -> ATGTCTCCGTG
CATTACGTCGG -> ATTACGTCGGC
CATTAGGAAGC -> ATTAGGAAGCC
CATTAGGCAGT -> ATTAGGCAGTG
CATTATGAGAA -> ATTATGAGAAG
CATTATTATGA -> ATTATTATGAG
CATTATTTACT -> ATTATTTACTC
CATTCCGAGCG -> ATTCCGAGCGG
CATTCGAATAC -> ATTCGAATACC
CATTGACGCAA -> ATTGACGCAAG
CATTTCTTGAG -> ATTTCTTGAGA
CATTTGAGTTC -> ATTTGAGTTCC
CATTTGTACGT -> ATTTGTACGTC
CATTTTGTAAG -> ATTTTGTAAGG
CCAAAAACATC -> CAAAAACATCA
CCAAAAGCCAA -> CAAAAGCCAAC
CCAACTGCAGA -> CAACTGCAGAC
CCAAGAGGTCC -> CAAGAGGTCCA
CCAATCGCACG -> CAATCGCACGC
CCACAACCCAT -> CACAACCCATT
CCACACCACTC -> CACACCACTCA
CCACATTAGGC -> CACATTAGGCA
CCACCACATTA -> CACCACATTAG
CCACCCTGGTA -> CACCCTGGTAA
CCACCTTGGGT -> CACCTTGGGTT
CCACTCATCCT -> CACTCATCCTG
CCACTCATTAT -> CACTCATTATT
CCAGAGTTGCC -> CAGAGTTGCCT
CCAGTCAAGAA -> CAGTCAAGAAT
CCAGTGATGTC -> CAGTGATGTCA
CCAGTGCACGA -> CAGTGCACGAC
CCATACAGCCC -> CATACAGCCCT
CCATACTACCT -> CATACTACCTT
CCATAGGTTTG -> CATAGGTTTGG
CCATATATCCT -> CATATATCCTA
CCATATTCATA -> CATATTCATAC
CCATCCCCCGT -> CATCCCCCGTC
CCATCCTAATT -> CATCCTAATTA
CCATCTTGGTT -> CATCTTGGTTT
CCATGGATACT -> CATGGATACTC
CCATGTAGGAG -> CATGTAGGAGA
CCATTAGGAAG -> CATTAGGAAGC
CCATTATGAGA -> CATTATGAGAA
CCATTGACGCA -> CATTGACGCAA
CCATTTCTTGA -> CATTTCTTGAG
CCCAAAAGCCA -> CCAAAAGCCAA
CCCACCACATT -> CCACCACATTA
CCCACCTTGGG -> CCACCTTGGGT
CCCAGTGATGT -> CCAGTGATGTC
CCCATAGGTTT -> CCATAGGTTTG
CCCATGGATAC -> CCATGGATACT
CCCATTGACGC -> CCATTGACGCA
CCCATTTCTTG -> CCATTTCTTGA
CCCCAAAAGCC -> CCCAAAAGCCA
CCCCATAGGTT -> CCCATAGGTTT
CCCCCAAAAGC -> CCCCAAAAGCC
CCCCCGTCAGG -> CCCCGTCAGGC
CCCCGCTATGG -> CCCGCTATGGG
CCCCGGGTAGG -> CCCGGGTAGGC
CCCCGTACTGG -> CCCGTACTGGT
CCCCGTCAGGC -> CCCGTCAGGCG
CCCCTTTTCAG -> CCCTTTTCAGT
CCCGAATTGAG -> CCGAATTGAGC
CCCGATTCTGG -> CCGATTCTGGT
CCCGCCTAGGC -> CCGCCTAGGCG
CCCGCCTTGTA -> CCGCCTTGTAC
CCCGCTATGGG -> CCGCTATGGGC
CCCGCTCTAGA -> CCGCTCTAGAG
CCCGGAAGACT -> CCGGAAGACTC
CCCGGGTAGGC -> CCGGGTAGGCG
CCCGGGTGCAC -> CCGGGTGCACG
CCCGGTTAGCG -> CCGGTTAGCGT
CCCGTACTGGT -> CCGTACTGGTG
CCCGTCAGGCG -> CCGTCAGGCGC
CCCGTCTCTGA -> CCGTCTCTGAA
CCCTAGAGCTA -> CCTAGAGCTAC
CCCTCAGTGGG -> CCTCAGTGGGC
CCCTGGTAATC -> CCTGGTAATCA
CCCTTTTCAGT -> CCTTTTCAGTA
CCGAAAAAGTG -> CGAAAAAGTGT
CCGAACCTTCG -> CGAACCTTCGA
CCGAATCGGAG -> CGAATCGGAGG
CCGAATTGAGC -> CGAATTGAGCC
CCGACCAGAGT -> CGACCAGAGTT
CCGACTACGTT -> CGACTACGTTC
CCGAGCGCCGT -> CGAGCGCCGTG
CCGAGCGGTCA -> CGAGCGGTCAT
CCGATAAGAAC -> CGATAAGAACA
CCGATTCTGGT -> CGATTCTGGTC
CCGCCTAGGCG -> CGCCTAGGCGA
CCGCCTGGCCT -> CGCCTGGCCTA
CCGCCTTGTAC -> CGCCTTGTACC
CCGCTAATACA -> CGCTAATACAT
CCGCTATGGGC -> CGCTATGGGCC
CCGCTCTAGAG -> CGCTCTAGAGC
CCGCTCTATAC -> CGCTCTATACC
CCGCTGGAAGC -> CGCTGGAAGCG
CCGGAAGACTC -> CGGAAGACTCA
CCGGAAGCGCA -> CGGAAGCGCAC
CCGGAGTTAAC -> CGGAGTTAACC
CCGGGAATTTT -> CGGGAATTTTA
CCGGGATCATA -> CGGGATCATAA
CCGGGTAGGCG -> CGGGTAGGCGG
CCGGGTCGAGG -> CGGGTCGAGGC
CCGGGTGCACG -> CGGGTGCACGA
CCGGTTAGCGT -> CGGTTAGCGTT
CCGGTTGACTT -> CGGTTGACTTC
CCGTACTGGTG -> CGTACTGGTGT
CCGTCACGGTA -> CGTCACGGTAT
CCGTCAGGCGC -> CGTCAGGCGCA
CCGTCTCTGAA -> CGTCTCTGAAA
CCGTGAGTACT -> CGTGAGTACTA
CCGTGGCCATA -> CGTGGCCATAT
CCGTGTCCATT -> CGTGTCCATTA
CCGTGTTCCTG -> CGTGTTCCTGA
CCGTTTTAGAT -> CGTTTTAGATC
CCTAAAGCGGG -> CTAAAGCGGGC
CCTAAGGACCA -> CTAAGGACCAT
CCTAATTATGT -> CTAATTATGTT
CCTAGAGCTAC -> CTAGAGCTACC
CCTAGGCGAGA -> CTAGGCGAGAA
CCTAGGGAGGG -> CTAGGGAGGGA
CCTAGTGAGTG -> CTAGTGAGTGT
CCTAGTTATTT -> CTAGTTATTTG
CCTCAACTACC -> CTCAACTACCT
CCTCAGCATAA -> CTCAGCATAAT
CCTCAGTGGGC -> CTCAGTGGGCT
CCTCATTATTA -> CTCATTATTAT
CCTCCCCGGGT -> CTCCCCGGGTA
CCTCGAAATGT -> CTCGAAATGTA
CCTCGGATAGA -> CTCGGATAGAG
CCTCGGTCGAG -> CTCGGTCGAGA
CCTCGTTCTAG -> CTCGTTCTAGG
CCTGAAACGGA -> CTGAAACGGAT
CCTGACATGTC -> CTGACATGTCT
CCTGACATTCG -> CTGACATTCGA
CCTGACCCATG -> CTGACCCATGG
CCTGACGTCGC -> CTGACGTCGCG
CCTGCAGACTG -> CTGCAGACTGT
CCTGCTAATCG -> CTGCTAATCGT
CCTGGCAATTA -> CTGGCAATTAT
CCTGGCACCCG -> CTGGCACCCGC
CCTGGCCTAGG -> CTGGCCTAGGG
CCTGGCTCCTC -> CTGGCTCCTCA
CCTGGTAATCA -> CTGGTAATCAA
CCTGGTGGGTG -> CTGGTGGGTGC
CCTTCCCGAAT -> CTTCCCGAATT
CCTTCCGGTTG -> CTTCCGGTTGA
CCTTCGAGGTC -> CTTCGAGGTCG
CCTTCTCTCCA -> CTTCTCTCCAC
CCTTGGGTTAT -> CTTGGGTTATC
CCTTGTACCAT -> CTTGTACCATG
CCTTTTCAGTA -> CTTTTCAGTAA
CGAAAAAGTGT -> GAAAAAGTGTA
CGAAAACCATC -> GAAAACCATCC
CGAAATGTACC -> GAAATGTACCC
CGAACCTTCGA -> GAACCTTCGAG
CGAACTTATCC -> GAACTTATCCC
CGAATACCCGC -> GAATACCCGCC
CGAATCGGAGG -> GAATCGGAGGA
CGAATTGAGCC -> GAATTGAGCCT
CGACACGCTTT -> GACACGCTTTG
CGACCAGAGTT -> GACCAGAGTTG
CGACGAGATTT -> GACGAGATTTA
CGACTACGTTC -> GACTACGTTCG
CGACTCTCACA -> GACTCTCACAG
CGACTGAACGA -> GACTGAACGAT
CGAGAACCATC -> GAGAACCATCT
CGAGACCAGTG -> GAGACCAGTGC
CGAGATTTATG -> GAGATTTATGC
CGAGCAAATTG -> GAGCAAATTGT
CGAGCAACAAA -> GAGCAACAAAA
CGAGCGCCGTG -> GAGCGCCGTGT
CGAGCGGTCAT -> GAGCGGTCATT
CGAGCTGCCTA -> GAGCTGCCTAA
CGAGGAAGCGC -> GAGGAAGCGCT
CGAGGCACATT -> GAGGCACATTA
CGAGGCGTGAA -> GAGGCGTGAAA
CGAGGTCGATA -> GAGGTCGATAT
CGAGGTGCTGG -> GAGGTGCTGGG
CGATAAGAACA -> GATAAGAACAC
CGATAGACAGA -> GATAGACAGAA
CGATATGAATC -> GATATGAATCA
CGATCCCTCAG -> GATCCCTCAGT
CGATGGTTCCA -> GATGGTTCCAA
CGATTACCGTC -> GATTACCGTCA
CGATTCTGGTC -> GATTCTGGTCG
CGATTGACAAA -> GATTGACAAAA
CGATTGGCTGT -> GATTGGCTGTG
CGCAAAAGTGC -> GCAAAAGTGCC
CGCAAGTTCTC -> GCAAGTTCTCC
CGCAAGTTTCG -> GCAAGTTTCGG
CGCACCGAGCG -> GCACCGAGCGC
CGCACCGGGAT -> GCACCGGGATC
CGCACGCAGAG -> GCACGCAGAGG
CGCACGGTGAC -> GCACGGTGACC
CGCAGAGGTCA -> GCAGAGGTCAG
CGCATACAAAC -> GCATACAAACA
CGCATCTGACA -> GCATCTGACAT
CGCCCACCTTG -> GCCCACCTTGG
CGCCCCTTTTC -> GCCCCTTTTCA
CGCCGTGTCCA -> GCCGTGTCCAT
CGCCGTGTTCC -> GCCGTGTTCCT
CGCCTAGGCGA -> GCCTAGGCGAG
CGCCTGGCCTA -> GCCTGGCCTAG
CGCCTTGTACC -> GCCTTGTACCA
CGCGAGGTGCT -> GCGAGGTGCTG
CGCGATTGGCT -> GCGATTGGCTG
CGCGCGAGGTG -> GCGCGAGGTGC
CGCGTGGATCG -> GCGTGGATCGC
CGCGTGGTTGA -> GCGTGGTTGAA
CGCTAATACAT -> GCTAATACATC
CGCTATGGGCC -> GCTATGGGCCT
CGCTCCGACCA -> GCTCCGACCAG
CGCTCTAGAGC -> GCTCTAGAGCA
CGCTCTATACC -> GCTCTATACCA
CGCTGGAAGCG -> GCTGGAAGCGC
CGCTTTGTTCG -> GCTTTGTTCGT
CGGAAGACTCA -> GGAAGACTCAG
CGGAAGCGCAC -> GGAAGCGCACC
CGGAGGACAAC -> GGAGGACAACA
CGGAGGTGGGG -> GGAGGTGGGGT
CGGAGTTAACC -> GGAGTTAACCT
CGGATAGAGCT -> GGATAGAGCTG
CGGATAGTTTG -> GGATAGTTTGG
CGGCAGGCCCG -> GGCAGGCCCGG
CGGCATGCCTC -> GGCATGCCTCA
CGGCCATATTC -> GGCCATATTCA
CGGCCTGACAT -> GGCCTGACATT
CGGGAATTTTA -> GGGAATTTTAT
CGGGATCATAA -> GGGATCATAAT
CGGGCTGCCTT -> GGGCTGCCTTC
CGGGTAGGCGG -> GGGTAGGCGGC
CGGGTCGAGGC -> GGGTCGAGGCA
CGGGTGCACGA -> GGGTGCACGAT
CGGGTTCATGC -> GGGTTCATGCA
CGGTACTTCTA -> GGTACTTCTAC
CGGTATATTCA -> GGTATATTCAC
CGGTCATTTTG -> GGTCATTTTGT
CGGTCGAGACC -> GGTCGAGACCA
CGGTGACCCGG -> GGTGACCCGGG
CGGTGTTATCA -> GGTGTTATCAG
CGGTTAGCGTT -> GGTTAGCGTTC
CGGTTGACTTC -> GGTTGACTTCG
CGTAAATACGA -> GTAAATACGAG
CGTACTGGTGT -> GTACTGGTGTA
CGTCACGGTAT -> GTCACGGTATA
CGTCAGGCGCA -> GTCAGGCGCAA
CGTCCTCCCCG -> GTCCTCCCCGG
CGTCGCATCTG -> GTCGCATCTGA
CGTCGCGTGGA -> GTCGCGTGGAT
CGTCGGCCATA -> GTCGGCCATAT
CGTCTCTGAAA -> GTCTCTGAAAA
CGTGAAAAACC -> GTGAAAAACCC
CGTGACGACTG -> GTGACGACTGA
CGTGAGTACTA -> GTGAGTACTAT
CGTGATTAGAT -> GTGATTAGATC
CGTGCTTGCAC -> GTGCTTGCACC
CGTGGATCGCC -> GTGGATCGCCC
CGTGGCCATAT -> GTGGCCATATA
CGTGGCCGGGA -> GTGGCCGGGAA
CGTGGCGAAAA -> GTGGCGAAAAC
CGTGGTTAAAA -> GTGGTTAAAAT
CGTGGTTGAAC -> GTGGTTGAACC
CGTGTCCATTA -> GTGTCCATTAG
CGTGTTCCTGA -> GTGTTCCTGAC
CGTTCGAGGAA -> GTTCGAGGAAG
CGTTCGTGACG -> GTTCGTGACGA
CGTTCTAGGCA -> GTTCTAGGCAA
CGTTGAGGTCA -> GTTGAGGTCAC
CGTTTACGAGG -> GTTTACGAGGC
CGTTTGATTTG -> GTTTGATTTGA
CGTTTGCTTGT -> GTTTGCTTGTC
CGTTTTAGATC -> GTTTTAGATCG
CTAAAGCGGGC -> TAAAGCGGGCT
CTAAAGTTGAG -> TAAAGTTGAGG
CTAAGGACCAT -> TAAGGACCATA
CTAATACATCG -> TAATACATCGG
CTAATCGTTGA -> TAATCGTTGAG
CTAATTATGTT -> TAATTATGTTT
CTACAAAAATG -> TACAAAAATGA
CTACCCCGTAC -> TACCCCGTACT
CTACCCGTCTC -> TACCCGTCTCT
CTACCTCGAAA -> TACCTCGAAAT
CTACCTGGCAC -> TACCTGGCACC
CTACCTTCCGG -> TACCTTCCGGT
CTACGTTCGTG -> TACGTTCGTGA
CTAGAGCAATG -> TAGAGCAATGA
CTAGAGCTACC -> TAGAGCTACCT
CTAGCAAGGGA -> TAGCAAGGGAT
CTAGGCAATTT -> TAGGCAATTTT
CTAGGCGAGAA -> TAGGCGAGAAC
CTAGGGACTGG -> TAGGGACTGGT
CTAGGGAGGGA -> TAGGGAGGGAA
CTAGTGAGTGT -> TAGTGAGTGTG
CTAGTTATTTG -> TAGTTATTTGG
CTAGTTCCACA -> TAGTTCCACAA
CTATACCACTC -> TATACCACTCA
CTATCAGTTCG -> TATCAGTTCGA
CTATCCTAGTT -> TATCCTAGTTA
CTATGCAACCC -> TATGCAACCCG
CTATGGGCCTC -> TATGGGCCTCG
CTATGTGCCGA -> TATGTGCCGAC
CTCAACTACCT -> TCAACTACCTG
CTCACAGCACT -> TCACAGCACTT
CTCAGAAGTAG -> TCAGAAGTAGA
CTCAGCATAAT -> TCAGCATAATC
CTCAGTGGGCT -> TCAGTGGGCTA
CTCATCCTGGC -> TCATCCTGGCA
CTCATTATTAT -> TCATTATTATG
CTCATTATTTA -> TCATTATTTAC
CTCATTCCGAG -> TCATTCCGAGC
CTCCACACCAC -> TCCACACCACT
CTCCATACAGC -> TCCATACAGCC
CTCCCCGGGTA -> TCCCCGGGTAG
CTCCGACCAGA -> TCCGACCAGAG
CTCCGTGAGTA -> TCCGTGAGTAC
CTCCGTGGCCA -> TCCGTGGCCAT
CTCCTCATTAT -> TCCTCATTATT
CTCCTCGTTCT -> TCCTCGTTCTA
CTCGAAATGTA -> TCGAAATGTAC
CTCGATTACCG -> TCGATTACCGT
CTCGGATAGAG -> TCGGATAGAGC
CTCGGTCGAGA -> TCGGTCGAGAC
CTCGTGCTTGC -> TCGTGCTTGCA
CTCGTTCTAGG -> TCGTTCTAGGC
CTCTAGAGCAA -> TCTAGAGCAAT
CTCTATACCAC -> TCTATACCACT
CTCTCACAGCA -> TCTCACAGCAC
CTCTCCACACC -> TCTCCACACCA
CTCTGAAAATA -> TCTGAAAATAA
CTGAAAATAAG -> TGAAAATAAGC
CTGAAACGGAT -> TGAAACGGATA
CTGAACAGCTC -> TGAACAGCTCG
CTGAACGATCC -> TGAACGATCCC
CTGACATGAGC -> TGACATGAGCG
CTGACATGTCT -> TGACATGTCTC
CTGACATTCGA -> TGACATTCGAA
CTGACCCATGG -> TGACCCATGGA
CTGACGTCGCG -> TGACGTCGCGT
CTGCAAGCTGT -> TGCAAGCTGTG
CTGCAGACGTT -> TGCAGACGTTT
CTGCAGACTGT -> TGCAGACTGTA
CTGCCTAAAGC -> TGCCTAAAGCG
CTGCCTAAGGA -> TGCCTAAGGAC
CTGCCTTCTCT -> TGCCTTCTCTC
CTGCTAATCGT -> TGCTAATCGTT
CTGGAAGCGCA -> TGGAAGCGCAC
CTGGCAAAAGT -> TGGCAAAAGTG
CTGGCAATTAT -> TGGCAATTATA
CTGGCACCCGC -> TGGCACCCGCT
CTGGCCTAGGG -> TGGCCTAGGGA
CTGGCGTAAAT -> TGGCGTAAATA
CTGGCTCCTCA -> TGGCTCCTCAT
CTGGGACTTCG -> TGGGACTTCGT
CTGGTAATCAA -> TGGTAATCAAC
CTGGTCCTGGC -> TGGTCCTGGCT
CTGGTCGGCCT -> TGGTCGGCCTG
CTGGTGGGTGC -> TGGTGGGTGCC
CTGGTGTAAAC -> TGGTGTAAACG
CTGTATCAGTG -> TGTATCAGTGA
CTGTGTACCAA -> TGTGTACCAAT
CTGTGTAGATT -> TGTGTAGATTG
CTGTTCCGGGT -> TGTTCCGGGTC
CTTAAGGGGCA -> TTAAGGGGCAT
CTTACAAGCTA -> TTACAAGCTAG
CTTATCCCGGA -> TTATCCCGGAA
CTTCATTTGTA -> TTCATTTGTAC
CTTCCCGAATT -> TTCCCGAATTG
CTTCCGGTTGA -> TTCCGGTTGAC
CTTCGAGGTCG -> TTCGAGGTCGA
CTTCGCCCACC -> TTCGCCCACCT
CTTCGTGGCCG -> TTCGTGGCCGG
CTTCTACAAAA -> TTCTACAAAAA
CTTCTCTCCAC -> TTCTCTCCACA
CTTGAGATTGC -> TTGAGATTGCG
CTTGCACCGAT -> TTGCACCGATA
CTTGGGTTATC -> TTGGGTTATCC
CTTGGTTTAAA -> TTGGTTTAAAG
CTTGTACCATG -> TTGTACCATGT
CTTGTATGTTC -> TTGTATGTTCC
CTTGTATTACG -> TTGTATTACGA
CTTGTCGCCGT -> TTGTCGCCGTG
CTTTGTTCGTG -> TTTGTTCGTGG
CTTTTCAGTAA -> TTTTCAGTAAC
CTTTTTTGGGA -> TTTTTTGGGAT
GAAAAACCCCA -> AAAAACCCCAT
GAAAAAGTGTA -> AAAAAGTGTAA
GAAAACCATCC -> AAAACCATCCC
GAAAATAAGCT -> AAAATAAGCTG
GAAACGGATAG -> AAACGGATAGT
GAAACGGCAGG -> AAACGGCAGGC
GAAACGTGATT -> AAACGTGATTA
GAAATGCCCCG -> AAATGCCCCGC
GAAATGTACCC -> AAATGTACCCG
GAACACCTTCC -> AACACCTTCCC
GAACAGCTCGA -> AACAGCTCGAT
GAACCATCTTG -> AACCATCTTGG
GAACCGCCTGG -> AACCGCCTGGC
GAACCGGAGTT -> AACCGGAGTTA
GAACCTTCGAG -> AACCTTCGAGG
GAACGATCCCT -> AACGATCCCTC
GAACTTATCCC -> AACTTATCCCG
GAACTTGTATT -> AACTTGTATTA
GAAGACTCAGA -> AAGACTCAGAA
GAAGATAGAAA -> AAGATAGAAAC
GAAGCCATTAT -> AAGCCATTATG
GAAGCCCATTT -> AAGCCCATTTC
GAAGCGCACCG -> AAGCGCACCGG
GAAGCGCACGG -> AAGCGCACGGT
GAAGCGCTCCG -> AAGCGCTCCGA
GAAGTAGAGGT -> AAGTAGAGGTG
GAATACCCGCC -> AATACCCGCCT
GAATAGACTAC -> AATAGACTACC
GAATCAGGACA -> AATCAGGACAC
GAATCGGAGGA -> AATCGGAGGAC
GAATGAAACGT -> AATGAAACGTG
GAATTGAGCCT -> AATTGAGCCTG
GAATTTCCTCG -> AATTTCCTCGG
GAATTTTATCC -> AATTTTATCCT
GACAAAAACGC -> ACAAAAACGCA
GACAACATTTG -> ACAACATTTGA
GACACGCTTTG -> ACACGCTTTGT
GACACTGTTCC -> ACACTGTTCCG
GACAGAAGATA -> ACAGAAGATAG
GACATGAGCGC -> ACATGAGCGCG
GACATGTCTCC -> ACATGTCTCCG
GACATTCGAAT -> ACATTCGAATA
GACCAGAGTTG -> ACCAGAGTTGC
GACCAGTGCAC -> ACCAGTGCACG
GACCATACTAC -> ACCATACTACC
GACCCATGGAT -> ACCCATGGATA
GACCCCCAAAA -> ACCCCCAAAAG
GACCCGGGTGC -> ACCCGGGTGCA
GACCGCTCTAT -> ACCGCTCTATA
GACGACTGAAC -> ACGACTGAACG
GACGAGATTTA -> ACGAGATTTAT
GACGCAAGTTC -> ACGCAAGTTCT
GACGCAAGTTT -> ACGCAAGTTTC
GACGTCGCGTG -> ACGTCGCGTGG
GACGTTTACGA -> ACGTTTACGAG
GACTACCCGTC -> ACTACCCGTCT
GACTACGTTCG -> ACTACGTTCGT
GACTATGTGCC -> ACTATGTGCCG
GACTCAGAAGT -> ACTCAGAAGTA
GACTCTCACAG -> ACTCTCACAGC
GACTGAACGAT -> ACTGAACGATC
GACTGGTCCTG -> ACTGGTCCTGG
GACTGTATCAG -> ACTGTATCAGT
GACTTCGCCCA -> ACTTCGCCCAC
GACTTCGTGGC -> ACTTCGTGGCC
GAGAAATGCCC -> AGAAATGCCCC
GAGAACCATCT -> AGAACCATCTT
GAGAACCGCCT -> AGAACCGCCTG
GAGAAGCCCAT -> AGAAGCCCATT
GAGACCAGTGC -> AGACCAGTGCA
GAGAGCTCCTC -> AGAGCTCCTCG
GAGATTGCGAG -> AGATTGCGAGC
GAGATTTATGC -> AGATTTATGCT
GAGCAAATTGT -> AGCAAATTGTC
GAGCAACAAAA -> AGCAACAAAAA
GAGCAATCGCG -> AGCAATCGCGC
GAGCAATGACT -> AGCAATGACTA
GAGCCTGACAT -> AGCCTGACATG
GAGCGCCGTGT -> AGCGCCGTGTC
GAGCGCGATTG -> AGCGCGATTGG
GAGCGGTCATT -> AGCGGTCATTT
GAGCTACCTCG -> AGCTACCTCGA
GAGCTCCTCGT -> AGCTCCTCGTT
GAGCTGCCTAA -> AGCTGCCTAAA
GAGCTGGCAAA -> AGCTGGCAAAA
GAGGAAGCGCT -> AGGAAGCGCTC
GAGGACAACAT -> AGGACAACATT
GAGGACCCCCA -> AGGACCCCCAA
GAGGCACATTA -> AGGCACATTAC
GAGGCGTGAAA -> AGGCGTGAAAA
GAGGGAATAGA -> AGGGAATAGAC
GAGGGCAGACC -> AGGGCAGACCG
GAGGTCACTGC -> AGGTCACTGCC
GAGGTCAGCAT -> AGGTCAGCATG
GAGGTCCACCC -> AGGTCCACCCT
GAGGTCGATAT -> AGGTCGATATG
GAGGTGCTGGG -> AGGTGCTGGGA
GAGGTGGGGTC -> AGGTGGGGTCG
GAGGTGGGTCC -> AGGTGGGTCCT
GAGTACTATGC -> AGTACTATGCA
GAGTCGAACTT -> AGTCGAACTTA
GAGTGGGTGTG -> AGTGGGTGTGC
GAGTGTGTCTA -> AGTGTGTCTAC
GAGTTAACCTC -> AGTTAACCTCA
GAGTTCCAAAA -> AGTTCCAAAAA
GAGTTGCCTGA -> AGTTGCCTGAC
GAGTTTCACCG -> AGTTTCACCGC
GATAAGAACAC -> ATAAGAACACC
GATACTCGTGC -> ATACTCGTGCT
GATAGAAACGG -> ATAGAAACGGC
GATAGACAGAA -> ATAGACAGAAG
GATAGAGCTGG -> ATAGAGCTGGC
GATAGTTTGGT -> ATAGTTTGGTG
GATATGAATCA -> ATATGAATCAG
GATCAAGCTCA -> ATCAAGCTCAT
GATCATAATTA -> ATCATAATTAT
GATCCCAGTGA -> ATCCCAGTGAT
GATCCCTCAGT -> ATCCCTCAGTG
GATCGCACCGA -> ATCGCACCGAG
GATCGCCCCTT -> ATCGCCCCTTT
GATCGGTGTTA -> ATCGGTGTTAT
GATCGTGGTTA -> ATCGTGGTTAA
GATGGTTCCAA -> ATGGTTCCAAG
GATGTCAGAAC -> ATGTCAGAACT
GATTACCGTCA -> ATTACCGTCAC
GATTAGATCCC -> ATTAGATCCCA
GATTCTGGTCG -> ATTCTGGTCGG
GATTCTTGTAT -> ATTCTTGTATG
GATTGACAAAA -> ATTGACAAAAA
GATTGCGAGCA -> ATTGCGAGCAA
GATTGGCTGTG -> ATTGGCTGTGT
GATTGGGGGGG -> ATTGGGGGGGG
GATTTATGCTT -> ATTTATGCTTA
GATTTGAATTT -> ATTTGAATTTC
GCAAAAGTGAT -> CAAAAGTGATC
GCAAAAGTGCC -> CAAAAGTGCCG
GCAAATTGTCC -> CAAATTGTCCG
GCAACAAAAAG -> CAACAAAAAGT
GCAACACTAGC -> CAACACTAGCA
GCAACCCGCCT -> CAACCCGCCTA
GCAAGCTGTGT -> CAAGCTGTGTA
GCAAGGGATTC -> CAAGGGATTCT
GCAAGTTCTCC -> CAAGTTCTCCA
GCAAGTTTCGG -> CAAGTTTCGGA
GCAATCGCGCG -> CAATCGCGCGA
GCAATGACTAT -> CAATGACTATG
GCAATTATATT -> CAATTATATTG
GCAATTTTCTT -> CAATTTTCTTC
GCACATTACGT -> CACATTACGTC
GCACCCGCTCT -> CACCCGCTCTA
GCACCGAGCGC -> CACCGAGCGCC
GCACCGATAAG -> CACCGATAAGA
GCACCGGGATC -> CACCGGGATCA
GCACGACGAGA -> CACGACGAGAT
GCACGATAGAC -> CACGATAGACA
GCACGCAGAGG -> CACGCAGAGGT
GCACGGTGACC -> CACGGTGACCC
GCACTTTTTTG -> CACTTTTTTGG
GCAGACCGCTC -> CAGACCGCTCT
GCAGACGTTTA -> CAGACGTTTAC
GCAGACTGTAT -> CAGACTGTATC
GCAGAGGTCAG -> CAGAGGTCAGC
GCAGAGTTTCA -> CAGAGTTTCAC
GCAGGCCCGGT -> CAGGCCCGGTT
GCAGTGTGGCT -> CAGTGTGGCTA
GCATAATCCAG -> CATAATCCAGT
GCATACAAACA -> CATACAAACAC
GCATATCGCGT -> CATATCGCGTG
GCATCTGACAT -> CATCTGACATG
GCATGCCGAAT -> CATGCCGAATC
GCATGCCTCAA -> CATGCCTCAAC
GCATGCTAGGG -> CATGCTAGGGA
GCATGGTCCTG -> CATGGTCCTGC
GCCAACTGCAG -> CCAACTGCAGA
GCCATATATCC -> CCATATATCCT
GCCATATTCAT -> CCATATTCATA
GCCATTATGAG -> CCATTATGAGA
GCCCACCTTGG -> CCCACCTTGGG
GCCCATTTCTT -> CCCATTTCTTG
GCCCCGCTATG -> CCCCGCTATGG
GCCCCTTTTCA -> CCCCTTTTCAG
GCCCGGTTAGC -> CCCGGTTAGCG
GCCCTAGAGCT -> CCCTAGAGCTA
GCCGAAAAAGT -> CCGAAAAAGTG
GCCGAACCTTC -> CCGAACCTTCG
GCCGAATCGGA -> CCGAATCGGAG
GCCGACTACGT -> CCGACTACGTT
GCCGCTAATAC -> CCGCTAATACA
GCCGGGAATTT -> CCGGGAATTTT
GCCGTGTCCAT -> CCGTGTCCATT
GCCGTGTTCCT -> CCGTGTTCCTG
GCCTAAAGCGG -> CCTAAAGCGGG
GCCTAAGGACC -> CCTAAGGACCA
GCCTAGGCGAG -> CCTAGGCGAGA
GCCTAGGGAGG -> CCTAGGGAGGG
GCCTCAACTAC -> CCTCAACTACC
GCCTCGGTCGA -> CCTCGGTCGAG
GCCTGACATGT -> CCTGACATGTC
GCCTGACATTC -> CCTGACATTCG
GCCTGACGTCG -> CCTGACGTCGC
GCCTGGCCTAG -> CCTGGCCTAGG
GCCTTCTCTCC -> CCTTCTCTCCA
GCCTTGTACCA -> CCTTGTACCAT
GCGAAAACCAT -> CGAAAACCATC
GCGAGAACCAT -> CGAGAACCATC
GCGAGCAACAA -> CGAGCAACAAA
GCGAGGTGCTG -> CGAGGTGCTGG
GCGATTGGCTG -> CGATTGGCTGT
GCGCAAAAGTG -> CGCAAAAGTGC
GCGCACCGGGA -> CGCACCGGGAT
GCGCACGGTGA -> CGCACGGTGAC
GCGCCGTGTCC -> CGCCGTGTCCA
GCGCGAGGTGC -> CGCGAGGTGCT
GCGCGATTGGC -> CGCGATTGGCT
GCGCTCCGACC -> CGCTCCGACCA
GCGGCATGCCT -> CGGCATGCCTC
GCGGGCTGCCT -> CGGGCTGCCTT
GCGGTCATTTT -> CGGTCATTTTG
GCGTAAATACG -> CGTAAATACGA
GCGTGAAAAAC -> CGTGAAAAACC
GCGTGGATCGC -> CGTGGATCGCC
GCGTGGTTGAA -> CGTGGTTGAAC
GCGTTCGAGGA -> CGTTCGAGGAA
GCTAAAGTTGA -> CTAAAGTTGAG
GCTAATACATC -> CTAATACATCG
GCTAATCGTTG -> CTAATCGTTGA
GCTACCTCGAA -> CTACCTCGAAA
GCTAGGGACTG -> CTAGGGACTGG
GCTAGTTCCAC -> CTAGTTCCACA
GCTATCCTAGT -> CTATCCTAGTT
GCTATGGGCCT -> CTATGGGCCTC
GCTCATTCCGA -> CTCATTCCGAG
GCTCCGACCAG -> CTCCGACCAGA
GCTCCTCATTA -> CTCCTCATTAT
GCTCCTCGTTC -> CTCCTCGTTCT
GCTCGATTACC -> CTCGATTACCG
GCTCTAGAGCA -> CTCTAGAGCAA
GCTCTATACCA -> CTCTATACCAC
GCTGAACAGCT -> CTGAACAGCTC
GCTGCAAGCTG -> CTGCAAGCTGT
GCTGCCTAAAG -> CTGCCTAAAGC
GCTGCCTTCTC -> CTGCCTTCTCT
GCTGGAAGCGC -> CTGGAAGCGCA
GCTGGCAAAAG -> CTGGCAAAAGT
GCTGGCGTAAA -> CTGGCGTAAAT
GCTGGGACTTC -> CTGGGACTTCG
GCTGTGTACCA -> CTGTGTACCAA
GCTGTGTAGAT -> CTGTGTAGATT
GCTTAAGGGGC -> CTTAAGGGGCA
GCTTACAAGCT -> CTTACAAGCTA
GCTTGCACCGA -> CTTGCACCGAT
GCTTGTCGCCG -> CTTGTCGCCGT
GCTTTGTTCGT -> CTTTGTTCGTG
GGAAGACTCAG -> GAAGACTCAGA
GGAAGCCATTA -> GAAGCCATTAT
GGAAGCGCACC -> GAAGCGCACCG
GGAAGCGCACG -> GAAGCGCACGG
GGAAGCGCTCC -> GAAGCGCTCCG
GGAATAGACTA -> GAATAGACTAC
GGAATTTTATC -> GAATTTTATCC
GGACAACATTT -> GACAACATTTG
GGACACTGTTC -> GACACTGTTCC
GGACCATACTA -> GACCATACTAC
GGACCCCCAAA -> GACCCCCAAAA
GGACTGGTCCT -> GACTGGTCCTG
GGACTTCGTGG -> GACTTCGTGGC
GGAGAAATGCC -> GAGAAATGCCC
GGAGAACCGCC -> GAGAACCGCCT
GGAGAGCTCCT -> GAGAGCTCCTC
GGAGCAATCGC -> GAGCAATCGCG
GGAGGACAACA -> GAGGACAACAT
GGAGGGAATAG -> GAGGGAATAGA
GGAGGTGGGGT -> GAGGTGGGGTC
GGAGTGGGTGT -> GAGTGGGTGTG
GGAGTTAACCT -> GAGTTAACCTC
GGATACTCGTG -> GATACTCGTGC
GGATAGAGCTG -> GATAGAGCTGG
GGATAGTTTGG -> GATAGTTTGGT
GGATCATAATT -> GATCATAATTA
GGATCGCACCG -> GATCGCACCGA
GGATCGCCCCT -> GATCGCCCCTT
GGATTCTTGTA -> GATTCTTGTAT
GGCAAAAGTGA -> GCAAAAGTGAT
GGCAATTATAT -> GCAATTATATT
GGCAATTTTCT -> GCAATTTTCTT
GGCACATTACG -> GCACATTACGT
GGCACCCGCTC -> GCACCCGCTCT
GGCAGACCGCT -> GCAGACCGCTC
GGCAGGCCCGG -> GCAGGCCCGGT
GGCAGTGTGGC -> GCAGTGTGGCT
GGCATGCCTCA -> GCATGCCTCAA
GGCATGCTAGG -> GCATGCTAGGG
GGCCATATATC -> GCCATATATCC
GGCCATATTCA -> GCCATATTCAT
GGCCCGGTTAG -> GCCCGGTTAGC
GGCCGCTAATA -> GCCGCTAATAC
GGCCGGGAATT -> GCCGGGAATTT
GGCCTAGGGAG -> GCCTAGGGAGG
GGCCTCGGTCG -> GCCTCGGTCGA
GGCCTGACATT -> GCCTGACATTC
GGCGAAAACCA -> GCGAAAACCAT
GGCGAGAACCA -> GCGAGAACCAT
GGCGCAAAAGT -> GCGCAAAAGTG
GGCGGCATGCC -> GCGGCATGCCT
GGCGTAAATAC -> GCGTAAATACG
GGCGTGAAAAA -> GCGTGAAAAAC
GGCTAAAGTTG -> GCTAAAGTTGA
GGCTATCCTAG -> GCTATCCTAGT
GGCTCCTCATT -> GCTCCTCATTA
GGCTGCCTTCT -> GCTGCCTTCTC
GGCTGTGTAGA -> GCTGTGTAGAT
GGGAATAGACT -> GGAATAGACTA
GGGAATTTTAT -> GGAATTTTATC
GGGACTGGTCC -> GGACTGGTCCT
GGGACTTCGTG -> GGACTTCGTGG
GGGAGAACCGC -> GGAGAACCGCC
GGGAGCAATCG -> GGAGCAATCGC
GGGAGGGAATA -> GGAGGGAATAG
GGGATCATAAT -> GGATCATAATT
GGGATCGCACC -> GGATCGCACCG
GGGATTCTTGT -> GGATTCTTGTA
GGGCAGACCGC -> GGCAGACCGCT
GGGCATGCTAG -> GGCATGCTAGG
GGGCCTCGGTC -> GGCCTCGGTCG
GGGCTAAAGTT -> GGCTAAAGTTG
GGGCTGCCTTC -> GGCTGCCTTCT
GGGGAGCAATC -> GGGAGCAATCG
GGGGCATGCTA -> GGGCATGCTAG
GGGGGAGCAAT -> GGGGAGCAATC
GGGGGGAGCAA -> GGGGGAGCAAT
GGGGGGGAGCA -> GGGGGGAGCAA
GGGGGGGGAGC -> GGGGGGGAGCA
GGGGTCGGGTT -> GGGTCGGGTTC
GGGTAGGCGGC -> GGTAGGCGGCA
GGGTCCTGAAA -> GGTCCTGAAAC
GGGTCGAGGCA -> GGTCGAGGCAC
GGGTCGGGTTC -> GGTCGGGTTCA
GGGTGCACGAT -> GGTGCACGATA
GGGTGCCGAAA -> GGTGCCGAAAA
GGGTGTGCTGG -> GGTGTGCTGGC
GGGTTATCCCT -> GGTTATCCCTC
GGGTTCATGCA -> GGTTCATGCAG
GGTAATCAACT -> GTAATCAACTA
GGTACTTCTAC -> GTACTTCTACA
GGTAGGCGGCA -> GTAGGCGGCAT
GGTATATTCAC -> GTATATTCACG
GGTCACGATTG -> GTCACGATTGA
GGTCACTGCCT -> GTCACTGCCTA
GGTCAGCATGG -> GTCAGCATGGT
GGTCATTTTGT -> GTCATTTTGTA
GGTCCACCCTG -> GTCCACCCTGG
GGTCCTGAAAC -> GTCCTGAAACG
GGTCCTGCAGA -> GTCCTGCAGAC
GGTCCTGGCTC -> GTCCTGGCTCC
GGTCGAGACCA -> GTCGAGACCAG
GGTCGAGGCAC -> GTCGAGGCACA
GGTCGATATGA -> GTCGATATGAA
GGTCGGCCTGA -> GTCGGCCTGAC
GGTCGGGTTCA -> GTCGGGTTCAT
GGTGACCCGGG -> GTGACCCGGGT
GGTGCACGATA -> GTGCACGATAG
GGTGCCGAAAA -> GTGCCGAAAAA
GGTGCTGGGAC -> GTGCTGGGACT
GGTGGGGTCGG -> GTGGGGTCGGG
GGTGGGTCCTG -> GTGGGTCCTGA
GGTGGGTGCCG -> GTGGGTGCCGA
GGTGTAAACGT -> GTGTAAACGTT
GGTGTGCTGGC -> GTGTGCTGGCG
GGTGTGGAGTG -> GTGTGGAGTGG
GGTGTTATCAG -> GTGTTATCAGG
GGTTAAAATTT -> GTTAAAATTTG
GGTTAGCGTTC -> GTTAGCGTTCG
GGTTATCCCTC -> GTTATCCCTCG
GGTTCATGCAG -> GTTCATGCAGA
GGTTCCAAGAG -> GTTCCAAGAGG
GGTTGAACCGG -> GTTGAACCGGA
GGTTGACTTCG -> GTTGACTTCGC
GGTTTAAAGCA -> GTTTAAAGCAT
GGTTTGGAGAG -> GTTTGGAGAGC
GTAAACGTTTG -> TAAACGTTTGA
GTAAATACGAG -> TAAATACGAGC
GTAACGATGGT -> TAACGATGGTT
GTAAGCTTAAG -> TAAGCTTAAGG
GTAAGGTCACG -> TAAGGTCACGA
GTAATCAACTA -> TAATCAACTAT
GTAATCGTCCT -> TAATCGTCCTC
GTACCAATCGC -> TACCAATCGCA
GTACCATGTAG -> TACCATGTAGG
GTACCCGATTC -> TACCCGATTCT
GTACGTCGCAT -> TACGTCGCATC
GTACTATGCAA -> TACTATGCAAC
GTACTGGTGTA -> TACTGGTGTAA
GTACTTCTACA -> TACTTCTACAA
GTAGAGGTGGG -> TAGAGGTGGGT
GTAGATTGGGG -> TAGATTGGGGG
GTAGGAGAAAT -> TAGGAGAAATG
GTAGGCGGCAT -> TAGGCGGCATG
GTATATTCACG -> TATATTCACGA
GTATCAGTGAC -> TATCAGTGACG
GTATGTTCCCA -> TATGTTCCCAC
GTATTACGACT -> TATTACGACTC
GTCAAGAATGA -> TCAAGAATGAA
GTCACGATTGA -> TCACGATTGAC
GTCACGGTATA -> TCACGGTATAT
GTCACTGCCTA -> TCACTGCCTAA
GTCAGAACTTG -> TCAGAACTTGT
GTCAGCATGGT -> TCAGCATGGTC
GTCAGGCGCAA -> TCAGGCGCAAA
GTCATTTTGTA -> TCATTTTGTAA
GTCCACCCTGG -> TCCACCCTGGT
GTCCATTAGGA -> TCCATTAGGAA
GTCCGTTTTAG -> TCCGTTTTAGA
GTCCTCCCCGG -> TCCTCCCCGGG
GTCCTGAAACG -> TCCTGAAACGG
GTCCTGCAGAC -> TCCTGCAGACT
GTCCTGGCTCC -> TCCTGGCTCCT
GTCCTGGTGGG -> TCCTGGTGGGT
GTCGAACTTAT -> TCGAACTTATC
GTCGAGACCAG -> TCGAGACCAGT
GTCGAGGCACA -> TCGAGGCACAT
GTCGATATGAA -> TCGATATGAAT
GTCGCATCTGA -> TCGCATCTGAC
GTCGCCGTGTT -> TCGCCGTGTTC
GTCGCGTGGAT -> TCGCGTGGATC
GTCGGCCATAT -> TCGGCCATATT
GTCGGCCTGAC -> TCGGCCTGACA
GTCGGGTTCAT -> TCGGGTTCATG
GTCTACCCCGT -> TCTACCCCGTA
GTCTCCGTGAG -> TCTCCGTGAGT
GTCTCTGAAAA -> TCTCTGAAAAT
GTGAAAAACCC -> TGAAAAACCCC
GTGACCCGGGT -> TGACCCGGGTG
GTGACGACTGA -> TGACGACTGAA
GTGACGCAAGT -> TGACGCAAGTT
GTGAGTACTAT -> TGAGTACTATG
GTGAGTGTGTC -> TGAGTGTGTCT
GTGATCAAGCT -> TGATCAAGCTC
GTGATGTCAGA -> TGATGTCAGAA
GTGATTAGATC -> TGATTAGATCC
GTGCAACACTA -> TGCAACACTAG
GTGCACGACGA -> TGCACGACGAG
GTGCACGATAG -> TGCACGATAGA
GTGCCGAAAAA -> TGCCGAAAAAG
GTGCCGAACCT -> TGCCGAACCTT
GTGCCGACTAC -> TGCCGACTACG
GTGCTGGCGTA -> TGCTGGCGTAA
GTGCTGGGACT -> TGCTGGGACTT
GTGCTTGCACC -> TGCTTGCACCG
GTGGAGTGGGT -> TGGAGTGGGTG
GTGGATCGCCC -> TGGATCGCCCC
GTGGCCATATA -> TGGCCATATAT
GTGGCCGGGAA -> TGGCCGGGAAT
GTGGCGAAAAC -> TGGCGAAAACC
GTGGCTATCCT -> TGGCTATCCTA
GTGGGCTAAAG -> TGGGCTAAAGT
GTGGGGTCGGG -> TGGGGTCGGGT
GTGGGTCCTGA -> TGGGTCCTGAA
GTGGGTGCCGA -> TGGGTGCCGAA
GTGGGTGTGCT -> TGGGTGTGCTG
GTGGTTAAAAT -> TGGTTAAAATT
GTGGTTGAACC -> TGGTTGAACCG
GTGTAAACGTT -> TGTAAACGTTT
GTGTAATCGTC -> TGTAATCGTCC
GTGTACCAATC -> TGTACCAATCG
GTGTAGATTGG -> TGTAGATTGGG
GTGTCCATTAG -> TGTCCATTAGG
GTGTCTACCCC -> TGTCTACCCCG
GTGTGCTGGCG -> TGTGCTGGCGT
GTGTGGAGTGG -> TGTGGAGTGGG
GTGTGGCTATC -> TGTGGCTATCC
GTGTGTCTACC -> TGTGTCTACCC
GTGTTATCAGG -> TGTTATCAGGG
GTGTTCCTGAC -> TGTTCCTGACC
GTTAAAATTTG -> TTAAAATTTGT
GTTAACCTCAG -> TTAACCTCAGC
GTTAGCGTTCG -> TTAGCGTTCGA
GTTATCAGGGA -> TTATCAGGGAG
GTTATCCCTCG -> TTATCCCTCGG
GTTATTTGGCC -> TTATTTGGCCG
GTTCATGCAGA -> TTCATGCAGAG
GTTCCAAAAAC -> TTCCAAAAACA
GTTCCAAGAGG -> TTCCAAGAGGT
GTTCCACAACC -> TTCCACAACCC
GTTCCCACCAC -> TTCCCACCACA
GTTCCGGGTCG -> TTCCGGGTCGA
GTTCCTGACCC -> TTCCTGACCCA
GTTCGAGCTGC -> TTCGAGCTGCC
GTTCGAGGAAG -> TTCGAGGAAGC
GTTCGTGACGA -> TTCGTGACGAC
GTTCGTGGCGA -> TTCGTGGCGAA
GTTCTAGGCAA -> TTCTAGGCAAT
GTTCTCCATAC -> TTCTCCATACA
GTTGAACCGGA -> TTGAACCGGAG
GTTGACTTCGC -> TTGACTTCGCC
GTTGAGGACCC -> TTGAGGACCCC
GTTGAGGTCAC -> TTGAGGTCACT
GTTGCCTGACG -> TTGCCTGACGT
GTTTAAAGCAT -> TTTAAAGCATA
GTTTACGAGGC -> TTTACGAGGCG
GTTTCACCGCT -> TTTCACCGCTG
GTTTCGGAGGT -> TTTCGGAGGTG
GTTTGAGTCGA -> TTTGAGTCGAA
GTTTGATTTGA -> TTTGATTTGAA
GTTTGCTTGTC -> TTTGCTTGTCG
GTTTGGAGAGC -> TTTGGAGAGCT
GTTTGGTGTGG -> TTTGGTGTGGA
GTTTTAGATCG -> TTTTAGATCGT
TAAAATTTGTG -> AAAATTTGTGC
TAAACGTTTGA -> AAACGTTTGAT
TAAAGCATATC -> AAAGCATATCG
TAAAGCGGGCT -> AAAGCGGGCTG
TAAAGTTGAGG -> AAAGTTGAGGA
TAAATACGAGC -> AAATACGAGCA
TAACCTCAGCA -> AACCTCAGCAT
TAACGATGGTT -> AACGATGGTTC
TAAGAACACCT -> AAGAACACCTT
TAAGCTGAACA -> AAGCTGAACAG
TAAGCTTAAGG -> AAGCTTAAGGG
TAAGGACCATA -> AAGGACCATAC
TAAGGGGCATG -> AAGGGGCATGC
TAAGGTCACGA -> AAGGTCACGAT
TAATACATCGG -> AATACATCGGT
TAATCAACTAT -> AATCAACTATC
TAATCCAGTCA -> AATCCAGTCAA
TAATCGTCCTC -> AATCGTCCTCC
TAATCGTTGAG -> AATCGTTGAGG
TAATTATGCTG -> AATTATGCTGC
TAATTATGTTT -> AATTATGTTTG
TACAAAAATGA -> ACAAAAATGAT
TACAAACACCG -> ACAAACACCGG
TACAAGCTAGT -> ACAAGCTAGTT
TACAGCCCTAG -> ACAGCCCTAGA
TACATCGGTAC -> ACATCGGTACT
TACCAATCGCA -> ACCAATCGCAC
TACCACTCATT -> ACCACTCATTA
TACCATGTAGG -> ACCATGTAGGA
TACCCCGTACT -> ACCCCGTACTG
TACCCGATTCT -> ACCCGATTCTG
TACCCGCCTTG -> ACCCGCCTTGT
TACCCGTCTCT -> ACCCGTCTCTG
TACCGTCACGG -> ACCGTCACGGT
TACCTCGAAAT -> ACCTCGAAATG
TACCTGGCACC -> ACCTGGCACCC
TACCTTCCGGT -> ACCTTCCGGTT
TACGACTCTCA -> ACGACTCTCAC
TACGAGCAAAT -> ACGAGCAAATT
TACGAGGCGTG -> ACGAGGCGTGA
TACGTCGCATC -> ACGTCGCATCT
TACGTCGGCCA -> ACGTCGGCCAT
TACGTTCGTGA -> ACGTTCGTGAC
TACGTTTGCTT -> ACGTTTGCTTG
TACTACCTTCC -> ACTACCTTCCG
TACTATGCAAC -> ACTATGCAACC
TACTCCGTGGC -> ACTCCGTGGCC
TACTCGTGCTT -> ACTCGTGCTTG
TACTGGTGTAA -> ACTGGTGTAAA
TACTTCTACAA -> ACTTCTACAAA
TAGAAACGGCA -> AGAAACGGCAG
TAGACAGAAGA -> AGACAGAAGAT
TAGACTACCCG -> AGACTACCCGT
TAGAGCAATGA -> AGAGCAATGAC
TAGAGCTACCT -> AGAGCTACCTC
TAGAGCTGGCA -> AGAGCTGGCAA
TAGAGGTGGGT -> AGAGGTGGGTC
TAGATCCCAGT -> AGATCCCAGTG
TAGATCGTGGT -> AGATCGTGGTT
TAGATTGGGGG -> AGATTGGGGGG
TAGCAAGGGAT -> AGCAAGGGATT
TAGCGTTCGAG -> AGCGTTCGAGG
TAGGAAGCCAT -> AGGAAGCCATT
TAGGAGAAATG -> AGGAGAAATGC
TAGGCAATTTT -> AGGCAATTTTC
TAGGCAGTGTG -> AGGCAGTGTGG
TAGGCGAGAAC -> AGGCGAGAACC
TAGGCGGCATG -> AGGCGGCATGC
TAGGGACTGGT -> AGGGACTGGTC
TAGGGAGGGAA -> AGGGAGGGAAT
TAGGTTTGGAG -> AGGTTTGGAGA
TAGTGAGTGTG -> AGTGAGTGTGT
TAGTTATTTGG -> AGTTATTTGGC
TAGTTCCACAA -> AGTTCCACAAC
TAGTTTGGTGT -> AGTTTGGTGTG
TATACCACTCA -> ATACCACTCAT
TATATCCTAGT -> ATATCCTAGTG
TATATTCACGA -> ATATTCACGAC
TATATTGCATG -> ATATTGCATGC
TATCAGGGAGA -> ATCAGGGAGAA
TATCAGTGACG -> ATCAGTGACGC
TATCAGTTCGA -> ATCAGTTCGAG
TATCCCGGAAG -> ATCCCGGAAGA
TATCCCTCGGA -> ATCCCTCGGAT
TATCCTAGTGA -> ATCCTAGTGAG
TATCCTAGTTA -> ATCCTAGTTAT
TATCCTGCTAA -> ATCCTGCTAAT
TATCGCGTGGT -> ATCGCGTGGTT
TATGAATCAGG -> ATGAATCAGGA
TATGAGAAGCC -> ATGAGAAGCCC
TATGAGGGCAG -> ATGAGGGCAGA
TATGCAACCCG -> ATGCAACCCGC
TATGCTGCAAG -> ATGCTGCAAGC
TATGCTTACAA -> ATGCTTACAAG
TATGGGCCTCG -> ATGGGCCTCGG
TATGTGCCGAC -> ATGTGCCGACT
TATGTTCCCAC -> ATGTTCCCACC
TATGTTTGAGT -> ATGTTTGAGTC
TATTACGACTC -> ATTACGACTCT
TATTATGAGGG -> ATTATGAGGGC
TATTCACGACA -> ATTCACGACAC
TATTCATACGT -> ATTCATACGTT
TATTGCATGCC -> ATTGCATGCCG
TATTTACTCCG -> ATTTACTCCGT
TATTTGGCCGC -> ATTTGGCCGCT
TCAACTACCTG -> CAACTACCTGG
TCAACTATCAG -> CAACTATCAGT
TCAAGAATGAA -> CAAGAATGAAA
TCAAGCTCATT -> CAAGCTCATTC
TCAATGTCCTG -> CAATGTCCTGG
TCACAGCACTT -> CACAGCACTTT
TCACCGCTGGA -> CACCGCTGGAA
TCACGACACGC -> CACGACACGCT
TCACGATTGAC -> CACGATTGACA
TCACGGTATAT -> CACGGTATATT
TCACTGCCTAA -> CACTGCCTAAG
TCAGAACTTGT -> CAGAACTTGTA
TCAGAAGTAGA -> CAGAAGTAGAG
TCAGCATAATC -> CAGCATAATCC
TCAGCATGGTC -> CAGCATGGTCC
TCAGGACACTG -> CAGGACACTGT
TCAGGCGCAAA -> CAGGCGCAAAA
TCAGGGAGAAC -> CAGGGAGAACC
TCAGTAACGAT -> CAGTAACGATG
TCAGTGACGCA -> CAGTGACGCAA
TCAGTGGGCTA -> CAGTGGGCTAA
TCAGTTCGAGC -> CAGTTCGAGCT
TCATAATTATG -> CATAATTATGC
TCATACGTTTG -> CATACGTTTGC
TCATCCTGGCA -> CATCCTGGCAA
TCATGCAGAGT -> CATGCAGAGTT
TCATTATTATG -> CATTATTATGA
TCATTATTTAC -> CATTATTTACT
TCATTCCGAGC -> CATTCCGAGCG
TCATTTGTACG -> CATTTGTACGT
TCATTTTGTAA -> CATTTTGTAAG
TCCAAAAACAT -> CCAAAAACATC
TCCAAGAGGTC -> CCAAGAGGTCC
TCCACAACCCA -> CCACAACCCAT
TCCACACCACT -> CCACACCACTC
TCCACCCTGGT -> CCACCCTGGTA
TCCAGTCAAGA -> CCAGTCAAGAA
TCCATACAGCC -> CCATACAGCCC
TCCATTAGGAA -> CCATTAGGAAG
TCCCACCACAT -> CCCACCACATT
TCCCAGTGATG -> CCCAGTGATGT
TCCCCCGTCAG -> CCCCCGTCAGG
TCCCCGGGTAG -> CCCCGGGTAGG
TCCCGAATTGA -> CCCGAATTGAG
TCCCGGAAGAC -> CCCGGAAGACT
TCCCTCAGTGG -> CCCTCAGTGGG
TCCGACCAGAG -> CCGACCAGAGT
TCCGAGCGGTC -> CCGAGCGGTCA
TCCGGGTCGAG -> CCGGGTCGAGG
TCCGGTTGACT -> CCGGTTGACTT
TCCGTGAGTAC -> CCGTGAGTACT
TCCGTGGCCAT -> CCGTGGCCATA
TCCGTTTTAGA -> CCGTTTTAGAT
TCCTAATTATG -> CCTAATTATGT
TCCTAGTGAGT -> CCTAGTGAGTG
TCCTAGTTATT -> CCTAGTTATTT
TCCTCATTATT -> CCTCATTATTA
TCCTCCCCGGG -> CCTCCCCGGGT
TCCTCGGATAG -> CCTCGGATAGA
TCCTCGTTCTA -> CCTCGTTCTAG
TCCTGAAACGG -> CCTGAAACGGA
TCCTGACCCAT -> CCTGACCCATG
TCCTGCAGACT -> CCTGCAGACTG
TCCTGCTAATC -> CCTGCTAATCG
TCCTGGCAATT -> CCTGGCAATTA
TCCTGGCTCCT -> CCTGGCTCCTC
TCCTGGTGGGT -> CCTGGTGGGTG
TCGAAATGTAC -> CGAAATGTACC
TCGAACTTATC -> CGAACTTATCC
TCGAATACCCG -> CGAATACCCGC
TCGAGACCAGT -> CGAGACCAGTG
TCGAGCTGCCT -> CGAGCTGCCTA
TCGAGGAAGCG -> CGAGGAAGCGC
TCGAGGCACAT -> CGAGGCACATT
TCGAGGTCGAT -> CGAGGTCGATA
TCGATATGAAT -> CGATATGAATC
TCGATTACCGT -> CGATTACCGTC
TCGCACCGAGC -> CGCACCGAGCG
TCGCACGCAGA -> CGCACGCAGAG
TCGCATCTGAC -> CGCATCTGACA
TCGCCCACCTT -> CGCCCACCTTG
TCGCCCCTTTT -> CGCCCCTTTTC
TCGCCGTGTTC -> CGCCGTGTTCC
TCGCGCGAGGT -> CGCGCGAGGTG
TCGCGTGGATC -> CGCGTGGATCG
TCGCGTGGTTG -> CGCGTGGTTGA
TCGGAGGACAA -> CGGAGGACAAC
TCGGAGGTGGG -> CGGAGGTGGGG
TCGGATAGAGC -> CGGATAGAGCT
TCGGCCATATT -> CGGCCATATTC
TCGGCCTGACA -> CGGCCTGACAT
TCGGGTTCATG -> CGGGTTCATGC
TCGGTACTTCT -> CGGTACTTCTA
TCGGTCGAGAC -> CGGTCGAGACC
TCGGTGTTATC -> CGGTGTTATCA
TCGTCCTCCCC -> CGTCCTCCCCG
TCGTGACGACT -> CGTGACGACTG
TCGTGCTTGCA -> CGTGCTTGCAC
TCGTGGCCGGG -> CGTGGCCGGGA
TCGTGGCGAAA -> CGTGGCGAAAA
TCGTGGTTAAA -> CGTGGTTAAAA
TCGTTCTAGGC -> CGTTCTAGGCA
TCGTTGAGGTC -> CGTTGAGGTCA
TCTACAAAAAT -> CTACAAAAATG
TCTACCCCGTA -> CTACCCCGTAC
TCTAGAGCAAT -> CTAGAGCAATG
TCTAGGCAATT -> CTAGGCAATTT
TCTATACCACT -> CTATACCACTC
TCTCACAGCAC -> CTCACAGCACT
TCTCCACACCA -> CTCCACACCAC
TCTCCATACAG -> CTCCATACAGC
TCTCCGTGAGT -> CTCCGTGAGTA
TCTCTCCACAC -> CTCTCCACACC
TCTCTGAAAAT -> CTCTGAAAATA
TCTGAAAATAA -> CTGAAAATAAG
TCTGACATGAG -> CTGACATGAGC
TCTGGTCGGCC -> CTGGTCGGCCT
TCTTCATTTGT -> CTTCATTTGTA
TCTTGAGATTG -> CTTGAGATTGC
TCTTGGTTTAA -> CTTGGTTTAAA
TCTTGTATGTT -> CTTGTATGTTC
TGAAAAACCCC -> GAAAAACCCCA
TGAAAATAAGC -> GAAAATAAGCT
TGAAACGGATA -> GAAACGGATAG
TGAAACGTGAT -> GAAACGTGATT
TGAACAGCTCG -> GAACAGCTCGA
TGAACCGGAGT -> GAACCGGAGTT
TGAACGATCCC -> GAACGATCCCT
TGAATCAGGAC -> GAATCAGGACA
TGAATTTCCTC -> GAATTTCCTCG
TGACAAAAACG -> GACAAAAACGC
TGACATGAGCG -> GACATGAGCGC
TGACATGTCTC -> GACATGTCTCC
TGACATTCGAA -> GACATTCGAAT
TGACCCATGGA -> GACCCATGGAT
TGACCCGGGTG -> GACCCGGGTGC
TGACGACTGAA -> GACGACTGAAC
TGACGCAAGTT -> GACGCAAGTTC,GACGCAAGTTT
TGACGTCGCGT -> GACGTCGCGTG
TGACTATGTGC -> GACTATGTGCC
TGACTTCGCCC -> GACTTCGCCCA
TGAGAAGCCCA -> GAGAAGCCCAT
TGAGATTGCGA -> GAGATTGCGAG
TGAGCCTGACA -> GAGCCTGACAT
TGAGCGCGATT -> GAGCGCGATTG
TGAGGACCCCC -> GAGGACCCCCA
TGAGGGCAGAC -> GAGGGCAGACC
TGAGGTCACTG -> GAGGTCACTGC
TGAGTACTATG -> GAGTACTATGC
TGAGTCGAACT -> GAGTCGAACTT
TGAGTGTGTCT -> GAGTGTGTCTA
TGAGTTCCAAA -> GAGTTCCAAAA
TGATCAAGCTC -> GATCAAGCTCA
TGATCGGTGTT -> GATCGGTGTTA
TGATGTCAGAA -> GATGTCAGAAC
TGATTAGATCC -> GATTAGATCCC
TGATTTGAATT -> GATTTGAATTT
TGCAACACTAG -> GCAACACTAGC
TGCAACCCGCC -> GCAACCCGCCT
TGCAAGCTGTG -> GCAAGCTGTGT
TGCACCGATAA -> GCACCGATAAG
TGCACGACGAG -> GCACGACGAGA
TGCACGATAGA -> GCACGATAGAC
TGCAGACGTTT -> GCAGACGTTTA
TGCAGACTGTA -> GCAGACTGTAT
TGCAGAGTTTC -> GCAGAGTTTCA
TGCATGCCGAA -> GCATGCCGAAT
TGCCCCGCTAT -> GCCCCGCTATG
TGCCGAAAAAG -> GCCGAAAAAGT
TGCCGAACCTT -> GCCGAACCTTC
TGCCGAATCGG -> GCCGAATCGGA
TGCCGACTACG -> GCCGACTACGT
TGCCTAAAGCG -> GCCTAAAGCGG
TGCCTAAGGAC -> GCCTAAGGACC
TGCCTCAACTA -> GCCTCAACTAC
TGCCTGACGTC -> GCCTGACGTCG
TGCCTTCTCTC -> GCCTTCTCTCC
TGCGAGCAACA -> GCGAGCAACAA
TGCTAATCGTT -> GCTAATCGTTG
TGCTAGGGACT -> GCTAGGGACTG
TGCTGCAAGCT -> GCTGCAAGCTG
TGCTGGCGTAA -> GCTGGCGTAAA
TGCTGGGACTT -> GCTGGGACTTC
TGCTTACAAGC -> GCTTACAAGCT
TGCTTGCACCG -> GCTTGCACCGA
TGCTTGTCGCC -> GCTTGTCGCCG
TGGAAGCGCAC -> GGAAGCGCACG
TGGAGAGCTCC -> GGAGAGCTCCT
TGGAGTGGGTG -> GGAGTGGGTGT
TGGATACTCGT -> GGATACTCGTG
TGGATCGCCCC -> GGATCGCCCCT
TGGCAAAAGTG -> GGCAAAAGTGA
TGGCAATTATA -> GGCAATTATAT
TGGCACCCGCT -> GGCACCCGCTC
TGGCCATATAT -> GGCCATATATC
TGGCCGCTAAT -> GGCCGCTAATA
TGGCCGGGAAT -> GGCCGGGAATT
TGGCCTAGGGA -> GGCCTAGGGAG
TGGCGAAAACC -> GGCGAAAACCA
TGGCGTAAATA -> GGCGTAAATAC
TGGCTATCCTA -> GGCTATCCTAG
TGGCTCCTCAT -> GGCTCCTCATT
TGGCTGTGTAG -> GGCTGTGTAGA
TGGGACTTCGT -> GGGACTTCGTG
TGGGATCGCAC -> GGGATCGCACC
TGGGCCTCGGT -> GGGCCTCGGTC
TGGGCTAAAGT -> GGGCTAAAGTT
TGGGGGGGGAG -> GGGGGGGGAGC
TGGGGTCGGGT -> GGGGTCGGGTT
TGGGTCCTGAA -> GGGTCCTGAAA
TGGGTGCCGAA -> GGGTGCCGAAA
TGGGTGTGCTG -> GGGTGTGCTGG
TGGGTTATCCC -> GGGTTATCCCT
TGGTAATCAAC -> GGTAATCAACT
TGGTCCTGCAG -> GGTCCTGCAGA
TGGTCCTGGCT -> GGTCCTGGCTC
TGGTCGGCCTG -> GGTCGGCCTGA
TGGTGGGTGCC -> GGTGGGTGCCG
TGGTGTAAACG -> GGTGTAAACGT
TGGTGTGGAGT -> GGTGTGGAGTG
TGGTTAAAATT -> GGTTAAAATTT
TGGTTCCAAGA -> GGTTCCAAGAG
TGGTTGAACCG -> GGTTGAACCGG
TGGTTTAAAGC -> GGTTTAAAGCA
TGTAAACGTTT -> GTAAACGTTTG
TGTAAGGTCAC -> GTAAGGTCACG
TGTAATCGTCC -> GTAATCGTCCT
TGTACCAATCG -> GTACCAATCGC
TGTACCATGTA -> GTACCATGTAG
TGTACCCGATT -> GTACCCGATTC
TGTACGTCGCA -> GTACGTCGCAT
TGTAGATTGGG -> GTAGATTGGGG
TGTAGGAGAAA -> GTAGGAGAAAT
TGTATCAGTGA -> GTATCAGTGAC
TGTATGTTCCC -> GTATGTTCCCA
TGTATTACGAC -> GTATTACGACT
TGTCAGAACTT -> GTCAGAACTTG
TGTCCATTAGG -> GTCCATTAGGA
TGTCCGTTTTA -> GTCCGTTTTAG
TGTCCTGGTGG -> GTCCTGGTGGG
TGTCGCCGTGT -> GTCGCCGTGTT
TGTCTACCCCG -> GTCTACCCCGT
TGTCTCCGTGA -> GTCTCCGTGAG
TGTGCAACACT -> GTGCAACACTA
TGTGCCGACTA -> GTGCCGACTAC
TGTGCTGGCGT -> GTGCTGGCGTA
TGTGGAGTGGG -> GTGGAGTGGGT
TGTGGCTATCC -> GTGGCTATCCT
TGTGTACCAAT -> GTGTACCAATC
TGTGTAGATTG -> GTGTAGATTGG
TGTGTCTACCC -> GTGTCTACCCC
TGTTATCAGGG -> GTTATCAGGGA
TGTTCCCACCA -> GTTCCCACCAC
TGTTCCGGGTC -> GTTCCGGGTCG
TGTTCCTGACC -> GTTCCTGACCC
TGTTCGTGGCG -> GTTCGTGGCGA
TGTTTGAGTCG -> GTTTGAGTCGA
TTAAAATTTGT -> TAAAATTTGTG
TTAAAGCATAT -> TAAAGCATATC
TTAACCTCAGC -> TAACCTCAGCA
TTAAGGGGCAT -> TAAGGGGCATG
TTACAAGCTAG -> TACAAGCTAGT
TTACCGTCACG -> TACCGTCACGG
TTACGACTCTC -> TACGACTCTCA
TTACGAGGCGT -> TACGAGGCGTG
TTACGTCGGCC -> TACGTCGGCCA
TTACTCCGTGG -> TACTCCGTGGC
TTAGATCCCAG -> TAGATCCCAGT
TTAGATCGTGG -> TAGATCGTGGT
TTAGCGTTCGA -> TAGCGTTCGAG
TTAGGAAGCCA -> TAGGAAGCCAT
TTAGGCAGTGT -> TAGGCAGTGTG
TTATATTGCAT -> TATATTGCATG
TTATCAGGGAG -> TATCAGGGAGA
TTATCCCGGAA -> TATCCCGGAAG
TTATCCCTCGG -> TATCCCTCGGA
TTATCCTGCTA -> TATCCTGCTAA
TTATGAGAAGC -> TATGAGAAGCC
TTATGAGGGCA -> TATGAGGGCAG
TTATGCTGCAA -> TATGCTGCAAG
TTATGCTTACA -> TATGCTTACAA
TTATGTTTGAG -> TATGTTTGAGT
TTATTATGAGG -> TATTATGAGGG
TTATTTACTCC -> TATTTACTCCG
TTATTTGGCCG -> TATTTGGCCGC
TTCACCGCTGG -> TCACCGCTGGA
TTCACGACACG -> TCACGACACGC
TTCAGTAACGA -> TCAGTAACGAT
TTCATACGTTT -> TCATACGTTTG
TTCATGCAGAG -> TCATGCAGAGT
TTCATTTGTAC -> TCATTTGTACG
TTCCAAAAACA -> TCCAAAAACAT
TTCCAAGAGGT -> TCCAAGAGGTC
TTCCACAACCC -> TCCACAACCCA
TTCCCACCACA -> TCCCACCACAT
TTCCCGAATTG -> TCCCGAATTGA
TTCCGAGCGGT -> TCCGAGCGGTC
TTCCGGGTCGA -> TCCGGGTCGAG
TTCCGGTTGAC -> TCCGGTTGACT
TTCCTCGGATA -> TCCTCGGATAG
TTCCTGACCCA -> TCCTGACCCAT
TTCGAATACCC -> TCGAATACCCG
TTCGAGCTGCC -> TCGAGCTGCCT
TTCGAGGAAGC -> TCGAGGAAGCG
TTCGAGGTCGA -> TCGAGGTCGAT
TTCGCCCACCT -> TCGCCCACCTT
TTCGGAGGTGG -> TCGGAGGTGGG
TTCGTGACGAC -> TCGTGACGACT
TTCGTGGCCGG -> TCGTGGCCGGG
TTCGTGGCGAA -> TCGTGGCGAAA
TTCTACAAAAA -> TCTACAAAAAT
TTCTAGGCAAT -> TCTAGGCAATT
TTCTCCATACA -> TCTCCATACAG
TTCTCTCCACA -> TCTCTCCACAC
TTCTGGTCGGC -> TCTGGTCGGCC
TTCTTCATTTG -> TCTTCATTTGT
TTCTTGAGATT -> TCTTGAGATTG
TTCTTGTATGT -> TCTTGTATGTT
TTGAACCGGAG -> TGAACCGGAGT
TTGAATTTCCT -> TGAATTTCCTC
TTGACAAAAAC -> TGACAAAAACG
TTGACGCAAGT -> TGACGCAAGTT
TTGACTTCGCC -> TGACTTCGCCC
TTGAGATTGCG -> TGAGATTGCGA
TTGAGCCTGAC -> TGAGCCTGACA
TTGAGGACCCC -> TGAGGACCCCC
TTGAGGTCACT -> TGAGGTCACTG
TTGAGTCGAAC -> TGAGTCGAACT
TTGAGTTCCAA -> TGAGTTCCAAA
TTGATTTGAAT -> TGATTTGAATT
TTGCACCGATA -> TGCACCGATAA
TTGCATGCCGA -> TGCATGCCGAA
TTGCCTGACGT -> TGCCTGACGTC
TTGCGAGCAAC -> TGCGAGCAACA
TTGCTTGTCGC -> TGCTTGTCGCC
TTGGAGAGCTC -> TGGAGAGCTCC
TTGGCCGCTAA -> TGGCCGCTAAT
TTGGCTGTGTA -> TGGCTGTGTAG
TTGGGATCGCA -> TGGGATCGCAC
TTGGGGGGGGA -> TGGGGGGGGAG
TTGGGTTATCC -> TGGGTTATCCC
TTGGTGTGGAG -> TGGTGTGGAGT
TTGGTTTAAAG -> TGGTTTAAAGC
TTGTAAGGTCA -> TGTAAGGTCAC
TTGTACCATGT -> TGTACCATGTA
TTGTACGTCGC -> TGTACGTCGCA
TTGTATGTTCC -> TGTATGTTCCC
TTGTATTACGA -> TGTATTACGAC
TTGTCCGTTTT -> TGTCCGTTTTA
TTGTCGCCGTG -> TGTCGCCGTGT
TTGTGCAACAC -> TGTGCAACACT
TTGTTCGTGGC -> TGTTCGTGGCG
TTTAAAGCATA -> TTAAAGCATAT
TTTACGAGGCG -> TTACGAGGCGT
TTTACTCCGTG -> TTACTCCGTGG
TTTAGATCGTG -> TTAGATCGTGG
TTTATCCTGCT -> TTATCCTGCTA
TTTATGCTTAC -> TTATGCTTACA
TTTCACCGCTG -> TTCACCGCTGG
TTTCAGTAACG -> TTCAGTAACGA
TTTCCTCGGAT -> TTCCTCGGATA
TTTCGGAGGTG -> TTCGGAGGTGG
TTTCTTCATTT -> TTCTTCATTTG
TTTCTTGAGAT -> TTCTTGAGATT
TTTGAATTTCC -> TTGAATTTCCT
TTTGAGTCGAA -> TTGAGTCGAAC
TTTGAGTTCCA -> TTGAGTTCCAA
TTTGATTTGAA -> TTGATTTGAAT
TTTGCTTGTCG -> TTGCTTGTCGC
TTTGGAGAGCT -> TTGGAGAGCTC
TTTGGCCGCTA -> TTGGCCGCTAA
TTTGGGATCGC -> TTGGGATCGCA
TTTGGTGTGGA -> TTGGTGTGGAG
TTTGTAAGGTC -> TTGTAAGGTCA
TTTGTACGTCG -> TTGTACGTCGC
TTTGTGCAACA -> TTGTGCAACAC
TTTGTTCGTGG -> TTGTTCGTGGC
TTTTAGATCGT -> TTTAGATCGTG
TTTTATCCTGC -> TTTATCCTGCT
TTTTCAGTAAC -> TTTCAGTAACG
TTTTCTTCATT -> TTTCTTCATTT
TTTTGGGATCG -> TTTGGGATCGC
TTTTGTAAGGT -> TTTGTAAGGTC
TTTTTGGGATC -> TTTTGGGATCG
TTTTTTGGGAT -> TTTTTGGGATC